ृ  :  ['ृ'] 

अ  :  ['अ'] 

आ  :  ['आ'] 

इ  :  ['इ'] 

ई  :  ['ई'] 

उ  :  ['उ'] 

ऊ  :  ['ऊ'] 

ऋ  :  ['ऋ'] 

ए  :  ['ए'] 

ऐ  :  ['ऐ'] 

ओ  :  ['ओ'] 

औ  :  ['औ'] 

अं  :  ['अ', 'ं'] 

अ:  :  ['अ', ':'] 

क  :  ['क'] 

ख  :  ['ख'] 

ग  :  ['ग'] 

घ  :  ['घ'] 

ड़  :  ['ड', '़'] 

ट  :  ['ट'] 

ठ  :  ['ठ'] 

ड  :  ['ड'] 

ढ  :  ['ढ'] 

ण  :  ['ण'] 

च  :  ['च'] 

छ  :  ['छ'] 

ज  :  ['ज'] 

झ  :  ['झ'] 

ञ  :  ['ञ'] 

त  :  ['त'] 

थ  :  ['थ'] 

द  :  ['द'] 

ध  :  ['ध'] 

न  :  ['न'] 

प  :  ['प'] 

फ  :  ['फ'] 

ब  :  ['ब'] 

भ  :  ['भ'] 

म  :  ['म'] 

य  :  ['य'] 

र  :  ['र'] 

ल  :  ['ल'] 

व  :  ['व'] 

श  :  ['श'] 

ष  :  ['ष'] 

स  :  ['स'] 

ह  :  ['ह'] 