   :  [' '] 

अ  :  ['अ'] 

आ  :  ['आ'] 

इ  :  ['इ'] 

ई  :  ['ई'] 

उ  :  ['उ'] 

ऊ  :  ['ऊ'] 

ऋ  :  ['ऋ'] 

ए  :  ['ए'] 

ऐ  :  ['ऐ'] 

ओ  :  ['ओ'] 

औ  :  ['औ'] 

अं  :  ['अ', 'ं'] 

अ:  :  ['अ', ':'] 

क्  :  ['क', '्'] 

क  :  ['क'] 

का  :  ['क', 'ा'] 

कि  :  ['क', 'ि'] 

की  :  ['क', 'ी'] 

कु  :  ['क', 'ु'] 

कू  :  ['क', 'ू'] 

के  :  ['क', 'े'] 

कै  :  ['क', 'ै'] 

को  :  ['क', 'ो'] 

कौ  :  ['क', 'ौ'] 

कं  :  ['क', 'ं'] 

कः  :  ['क', 'ः'] 

कृ्  :  ['क', 'ृ', '्'] 

कृ  :  ['क', 'ृ'] 

कृा  :  ['क', 'ृ', 'ा'] 

कृि  :  ['क', 'ृ', 'ि'] 

कृी  :  ['क', 'ृ', 'ी'] 

कृु  :  ['क', 'ृ', 'ु'] 

कृू  :  ['क', 'ृ', 'ू'] 

कृे  :  ['क', 'ृ', 'े'] 

कृै  :  ['क', 'ृ', 'ै'] 

कृो  :  ['क', 'ृ', 'ो'] 

कृौ  :  ['क', 'ृ', 'ौ'] 

कृं  :  ['क', 'ृ', 'ं'] 

कृः  :  ['क', 'ृ', 'ः'] 

क्र्  :  ['क', '्', 'र', '्'] 

क्र  :  ['क', '्', 'र'] 

क्रा  :  ['क', '्', 'र', 'ा'] 

क्रि  :  ['क', '्', 'र', 'ि'] 

क्री  :  ['क', '्', 'र', 'ी'] 

क्रु  :  ['क', '्', 'र', 'ु'] 

क्रू  :  ['क', '्', 'र', 'ू'] 

क्रे  :  ['क', '्', 'र', 'े'] 

क्रै  :  ['क', '्', 'र', 'ै'] 

क्रो  :  ['क', '्', 'र', 'ो'] 

क्रौ  :  ['क', '्', 'र', 'ौ'] 

क्रं  :  ['क', '्', 'र', 'ं'] 

क्रः  :  ['क', '्', 'र', 'ः'] 

र्क्  :  ['र', '्', 'क', '्'] 

र्क  :  ['र', '्', 'क'] 

र्का  :  ['र', '्', 'क', 'ा'] 

र्कि  :  ['र', '्', 'क', 'ि'] 

र्की  :  ['र', '्', 'क', 'ी'] 

र्कु  :  ['र', '्', 'क', 'ु'] 

र्कू  :  ['र', '्', 'क', 'ू'] 

र्के  :  ['र', '्', 'क', 'े'] 

र्कै  :  ['र', '्', 'क', 'ै'] 

र्को  :  ['र', '्', 'क', 'ो'] 

र्कौ  :  ['र', '्', 'क', 'ौ'] 

र्कं  :  ['र', '्', 'क', 'ं'] 

र्कः  :  ['र', '्', 'क', 'ः'] 

ख्  :  ['ख', '्'] 

ख  :  ['ख'] 

खा  :  ['ख', 'ा'] 

खि  :  ['ख', 'ि'] 

खी  :  ['ख', 'ी'] 

खु  :  ['ख', 'ु'] 

खू  :  ['ख', 'ू'] 

खे  :  ['ख', 'े'] 

खै  :  ['ख', 'ै'] 

खो  :  ['ख', 'ो'] 

खौ  :  ['ख', 'ौ'] 

खं  :  ['ख', 'ं'] 

खः  :  ['ख', 'ः'] 

खृ्  :  ['ख', 'ृ', '्'] 

खृ  :  ['ख', 'ृ'] 

खृा  :  ['ख', 'ृ', 'ा'] 

खृि  :  ['ख', 'ृ', 'ि'] 

खृी  :  ['ख', 'ृ', 'ी'] 

खृु  :  ['ख', 'ृ', 'ु'] 

खृू  :  ['ख', 'ृ', 'ू'] 

खृे  :  ['ख', 'ृ', 'े'] 

खृै  :  ['ख', 'ृ', 'ै'] 

खृो  :  ['ख', 'ृ', 'ो'] 

खृौ  :  ['ख', 'ृ', 'ौ'] 

खृं  :  ['ख', 'ृ', 'ं'] 

खृः  :  ['ख', 'ृ', 'ः'] 

ख्र्  :  ['ख', '्', 'र', '्'] 

ख्र  :  ['ख', '्', 'र'] 

ख्रा  :  ['ख', '्', 'र', 'ा'] 

ख्रि  :  ['ख', '्', 'र', 'ि'] 

ख्री  :  ['ख', '्', 'र', 'ी'] 

ख्रु  :  ['ख', '्', 'र', 'ु'] 

ख्रू  :  ['ख', '्', 'र', 'ू'] 

ख्रे  :  ['ख', '्', 'र', 'े'] 

ख्रै  :  ['ख', '्', 'र', 'ै'] 

ख्रो  :  ['ख', '्', 'र', 'ो'] 

ख्रौ  :  ['ख', '्', 'र', 'ौ'] 

ख्रं  :  ['ख', '्', 'र', 'ं'] 

ख्रः  :  ['ख', '्', 'र', 'ः'] 

र्ख्  :  ['र', '्', 'ख', '्'] 

र्ख  :  ['र', '्', 'ख'] 

र्खा  :  ['र', '्', 'ख', 'ा'] 

र्खि  :  ['र', '्', 'ख', 'ि'] 

र्खी  :  ['र', '्', 'ख', 'ी'] 

र्खु  :  ['र', '्', 'ख', 'ु'] 

र्खू  :  ['र', '्', 'ख', 'ू'] 

र्खे  :  ['र', '्', 'ख', 'े'] 

र्खै  :  ['र', '्', 'ख', 'ै'] 

र्खो  :  ['र', '्', 'ख', 'ो'] 

र्खौ  :  ['र', '्', 'ख', 'ौ'] 

र्खं  :  ['र', '्', 'ख', 'ं'] 

र्खः  :  ['र', '्', 'ख', 'ः'] 

ग्  :  ['ग', '्'] 

ग  :  ['ग'] 

गा  :  ['ग', 'ा'] 

गि  :  ['ग', 'ि'] 

गी  :  ['ग', 'ी'] 

गु  :  ['ग', 'ु'] 

गू  :  ['ग', 'ू'] 

गे  :  ['ग', 'े'] 

गै  :  ['ग', 'ै'] 

गो  :  ['ग', 'ो'] 

गौ  :  ['ग', 'ौ'] 

गं  :  ['ग', 'ं'] 

गः  :  ['ग', 'ः'] 

गृ्  :  ['ग', 'ृ', '्'] 

गृ  :  ['ग', 'ृ'] 

गृा  :  ['ग', 'ृ', 'ा'] 

गृि  :  ['ग', 'ृ', 'ि'] 

गृी  :  ['ग', 'ृ', 'ी'] 

गृु  :  ['ग', 'ृ', 'ु'] 

गृू  :  ['ग', 'ृ', 'ू'] 

गृे  :  ['ग', 'ृ', 'े'] 

गृै  :  ['ग', 'ृ', 'ै'] 

गृो  :  ['ग', 'ृ', 'ो'] 

गृौ  :  ['ग', 'ृ', 'ौ'] 

गृं  :  ['ग', 'ृ', 'ं'] 

गृः  :  ['ग', 'ृ', 'ः'] 

ग्र्  :  ['ग', '्', 'र', '्'] 

ग्र  :  ['ग', '्', 'र'] 

ग्रा  :  ['ग', '्', 'र', 'ा'] 

ग्रि  :  ['ग', '्', 'र', 'ि'] 

ग्री  :  ['ग', '्', 'र', 'ी'] 

ग्रु  :  ['ग', '्', 'र', 'ु'] 

ग्रू  :  ['ग', '्', 'र', 'ू'] 

ग्रे  :  ['ग', '्', 'र', 'े'] 

ग्रै  :  ['ग', '्', 'र', 'ै'] 

ग्रो  :  ['ग', '्', 'र', 'ो'] 

ग्रौ  :  ['ग', '्', 'र', 'ौ'] 

ग्रं  :  ['ग', '्', 'र', 'ं'] 

ग्रः  :  ['ग', '्', 'र', 'ः'] 

र्ग्  :  ['र', '्', 'ग', '्'] 

र्ग  :  ['र', '्', 'ग'] 

र्गा  :  ['र', '्', 'ग', 'ा'] 

र्गि  :  ['र', '्', 'ग', 'ि'] 

र्गी  :  ['र', '्', 'ग', 'ी'] 

र्गु  :  ['र', '्', 'ग', 'ु'] 

र्गू  :  ['र', '्', 'ग', 'ू'] 

र्गे  :  ['र', '्', 'ग', 'े'] 

र्गै  :  ['र', '्', 'ग', 'ै'] 

र्गो  :  ['र', '्', 'ग', 'ो'] 

र्गौ  :  ['र', '्', 'ग', 'ौ'] 

र्गं  :  ['र', '्', 'ग', 'ं'] 

र्गः  :  ['र', '्', 'ग', 'ः'] 

घ्  :  ['घ', '्'] 

घ  :  ['घ'] 

घा  :  ['घ', 'ा'] 

घि  :  ['घ', 'ि'] 

घी  :  ['घ', 'ी'] 

घु  :  ['घ', 'ु'] 

घू  :  ['घ', 'ू'] 

घे  :  ['घ', 'े'] 

घै  :  ['घ', 'ै'] 

घो  :  ['घ', 'ो'] 

घौ  :  ['घ', 'ौ'] 

घं  :  ['घ', 'ं'] 

घः  :  ['घ', 'ः'] 

घृ्  :  ['घ', 'ृ', '्'] 

घृ  :  ['घ', 'ृ'] 

घृा  :  ['घ', 'ृ', 'ा'] 

घृि  :  ['घ', 'ृ', 'ि'] 

घृी  :  ['घ', 'ृ', 'ी'] 

घृु  :  ['घ', 'ृ', 'ु'] 

घृू  :  ['घ', 'ृ', 'ू'] 

घृे  :  ['घ', 'ृ', 'े'] 

घृै  :  ['घ', 'ृ', 'ै'] 

घृो  :  ['घ', 'ृ', 'ो'] 

घृौ  :  ['घ', 'ृ', 'ौ'] 

घृं  :  ['घ', 'ृ', 'ं'] 

घृः  :  ['घ', 'ृ', 'ः'] 

घ्र्  :  ['घ', '्', 'र', '्'] 

घ्र  :  ['घ', '्', 'र'] 

घ्रा  :  ['घ', '्', 'र', 'ा'] 

घ्रि  :  ['घ', '्', 'र', 'ि'] 

घ्री  :  ['घ', '्', 'र', 'ी'] 

घ्रु  :  ['घ', '्', 'र', 'ु'] 

घ्रू  :  ['घ', '्', 'र', 'ू'] 

घ्रे  :  ['घ', '्', 'र', 'े'] 

घ्रै  :  ['घ', '्', 'र', 'ै'] 

घ्रो  :  ['घ', '्', 'र', 'ो'] 

घ्रौ  :  ['घ', '्', 'र', 'ौ'] 

घ्रं  :  ['घ', '्', 'र', 'ं'] 

घ्रः  :  ['घ', '्', 'र', 'ः'] 

र्घ्  :  ['र', '्', 'घ', '्'] 

र्घ  :  ['र', '्', 'घ'] 

र्घा  :  ['र', '्', 'घ', 'ा'] 

र्घि  :  ['र', '्', 'घ', 'ि'] 

र्घी  :  ['र', '्', 'घ', 'ी'] 

र्घु  :  ['र', '्', 'घ', 'ु'] 

र्घू  :  ['र', '्', 'घ', 'ू'] 

र्घे  :  ['र', '्', 'घ', 'े'] 

र्घै  :  ['र', '्', 'घ', 'ै'] 

र्घो  :  ['र', '्', 'घ', 'ो'] 

र्घौ  :  ['र', '्', 'घ', 'ौ'] 

र्घं  :  ['र', '्', 'घ', 'ं'] 

र्घः  :  ['र', '्', 'घ', 'ः'] 

ड़्  :  ['ड', '़', '्'] 

ड़  :  ['ड', '़'] 

ड़ा  :  ['ड', '़', 'ा'] 

ड़ि  :  ['ड', '़', 'ि'] 

ड़ी  :  ['ड', '़', 'ी'] 

ड़ु  :  ['ड', '़', 'ु'] 

ड़ू  :  ['ड', '़', 'ू'] 

ड़े  :  ['ड', '़', 'े'] 

ड़ै  :  ['ड', '़', 'ै'] 

ड़ो  :  ['ड', '़', 'ो'] 

ड़ौ  :  ['ड', '़', 'ौ'] 

ड़ं  :  ['ड', '़', 'ं'] 

ड़ः  :  ['ड', '़', 'ः'] 

ड़ृ्  :  ['ड', '़', 'ृ', '्'] 

ड़ृ  :  ['ड', '़', 'ृ'] 

ड़ृा  :  ['ड', '़', 'ृ', 'ा'] 

ड़ृि  :  ['ड', '़', 'ृ', 'ि'] 

ड़ृी  :  ['ड', '़', 'ृ', 'ी'] 

ड़ृु  :  ['ड', '़', 'ृ', 'ु'] 

ड़ृू  :  ['ड', '़', 'ृ', 'ू'] 

ड़ृे  :  ['ड', '़', 'ृ', 'े'] 

ड़ृै  :  ['ड', '़', 'ृ', 'ै'] 

ड़ृो  :  ['ड', '़', 'ृ', 'ो'] 

ड़ृौ  :  ['ड', '़', 'ृ', 'ौ'] 

ड़ृं  :  ['ड', '़', 'ृ', 'ं'] 

ड़ृः  :  ['ड', '़', 'ृ', 'ः'] 

ड़्र्  :  ['ड़', '्', 'र', '्'] 

ड़्र  :  ['ड़', '्', 'र'] 

ड़्रा  :  ['ड़', '्', 'र', 'ा'] 

ड़्रि  :  ['ड़', '्', 'र', 'ि'] 

ड़्री  :  ['ड़', '्', 'र', 'ी'] 

ड़्रु  :  ['ड़', '्', 'र', 'ु'] 

ड़्रू  :  ['ड़', '्', 'र', 'ू'] 

ड़्रे  :  ['ड़', '्', 'र', 'े'] 

ड़्रै  :  ['ड़', '्', 'र', 'ै'] 

ड़्रो  :  ['ड़', '्', 'र', 'ो'] 

ड़्रौ  :  ['ड़', '्', 'र', 'ौ'] 

ड़्रं  :  ['ड़', '्', 'र', 'ं'] 

ड़्रः  :  ['ड़', '्', 'र', 'ः'] 

र्ड़्  :  ['र', '्', 'ड', '़', '्'] 

र्ड़  :  ['र', '्', 'ड', '़'] 

र्ड़ा  :  ['र', '्', 'ड', '़', 'ा'] 

र्ड़ि  :  ['र', '्', 'ड', '़', 'ि'] 

र्ड़ी  :  ['र', '्', 'ड', '़', 'ी'] 

र्ड़ु  :  ['र', '्', 'ड', '़', 'ु'] 

र्ड़ू  :  ['र', '्', 'ड', '़', 'ू'] 

र्ड़े  :  ['र', '्', 'ड', '़', 'े'] 

र्ड़ै  :  ['र', '्', 'ड', '़', 'ै'] 

र्ड़ो  :  ['र', '्', 'ड', '़', 'ो'] 

र्ड़ौ  :  ['र', '्', 'ड', '़', 'ौ'] 

र्ड़ं  :  ['र', '्', 'ड', '़', 'ं'] 

र्ड़ः  :  ['र', '्', 'ड', '़', 'ः'] 

ट्  :  ['ट', '्'] 

ट  :  ['ट'] 

टा  :  ['ट', 'ा'] 

टि  :  ['ट', 'ि'] 

टी  :  ['ट', 'ी'] 

टु  :  ['ट', 'ु'] 

टू  :  ['ट', 'ू'] 

टे  :  ['ट', 'े'] 

टै  :  ['ट', 'ै'] 

टो  :  ['ट', 'ो'] 

टौ  :  ['ट', 'ौ'] 

टं  :  ['ट', 'ं'] 

टः  :  ['ट', 'ः'] 

टृ्  :  ['ट', 'ृ', '्'] 

टृ  :  ['ट', 'ृ'] 

टृा  :  ['ट', 'ृ', 'ा'] 

टृि  :  ['ट', 'ृ', 'ि'] 

टृी  :  ['ट', 'ृ', 'ी'] 

टृु  :  ['ट', 'ृ', 'ु'] 

टृू  :  ['ट', 'ृ', 'ू'] 

टृे  :  ['ट', 'ृ', 'े'] 

टृै  :  ['ट', 'ृ', 'ै'] 

टृो  :  ['ट', 'ृ', 'ो'] 

टृौ  :  ['ट', 'ृ', 'ौ'] 

टृं  :  ['ट', 'ृ', 'ं'] 

टृः  :  ['ट', 'ृ', 'ः'] 

ट्र्  :  ['ट', '्', 'र', '्'] 

ट्र  :  ['ट', '्', 'र'] 

ट्रा  :  ['ट', '्', 'र', 'ा'] 

ट्रि  :  ['ट', '्', 'र', 'ि'] 

ट्री  :  ['ट', '्', 'र', 'ी'] 

ट्रु  :  ['ट', '्', 'र', 'ु'] 

ट्रू  :  ['ट', '्', 'र', 'ू'] 

ट्रे  :  ['ट', '्', 'र', 'े'] 

ट्रै  :  ['ट', '्', 'र', 'ै'] 

ट्रो  :  ['ट', '्', 'र', 'ो'] 

ट्रौ  :  ['ट', '्', 'र', 'ौ'] 

ट्रं  :  ['ट', '्', 'र', 'ं'] 

ट्रः  :  ['ट', '्', 'र', 'ः'] 

र्ट्  :  ['र', '्', 'ट', '्'] 

र्ट  :  ['र', '्', 'ट'] 

र्टा  :  ['र', '्', 'ट', 'ा'] 

र्टि  :  ['र', '्', 'ट', 'ि'] 

र्टी  :  ['र', '्', 'ट', 'ी'] 

र्टु  :  ['र', '्', 'ट', 'ु'] 

र्टू  :  ['र', '्', 'ट', 'ू'] 

र्टे  :  ['र', '्', 'ट', 'े'] 

र्टै  :  ['र', '्', 'ट', 'ै'] 

र्टो  :  ['र', '्', 'ट', 'ो'] 

र्टौ  :  ['र', '्', 'ट', 'ौ'] 

र्टं  :  ['र', '्', 'ट', 'ं'] 

र्टः  :  ['र', '्', 'ट', 'ः'] 

ठ्  :  ['ठ', '्'] 

ठ  :  ['ठ'] 

ठा  :  ['ठ', 'ा'] 

ठि  :  ['ठ', 'ि'] 

ठी  :  ['ठ', 'ी'] 

ठु  :  ['ठ', 'ु'] 

ठू  :  ['ठ', 'ू'] 

ठे  :  ['ठ', 'े'] 

ठै  :  ['ठ', 'ै'] 

ठो  :  ['ठ', 'ो'] 

ठौ  :  ['ठ', 'ौ'] 

ठं  :  ['ठ', 'ं'] 

ठः  :  ['ठ', 'ः'] 

ठृ्  :  ['ठ', 'ृ', '्'] 

ठृ  :  ['ठ', 'ृ'] 

ठृा  :  ['ठ', 'ृ', 'ा'] 

ठृि  :  ['ठ', 'ृ', 'ि'] 

ठृी  :  ['ठ', 'ृ', 'ी'] 

ठृु  :  ['ठ', 'ृ', 'ु'] 

ठृू  :  ['ठ', 'ृ', 'ू'] 

ठृे  :  ['ठ', 'ृ', 'े'] 

ठृै  :  ['ठ', 'ृ', 'ै'] 

ठृो  :  ['ठ', 'ृ', 'ो'] 

ठृौ  :  ['ठ', 'ृ', 'ौ'] 

ठृं  :  ['ठ', 'ृ', 'ं'] 

ठृः  :  ['ठ', 'ृ', 'ः'] 

ठ्र्  :  ['ठ', '्', 'र', '्'] 

ठ्र  :  ['ठ', '्', 'र'] 

ठ्रा  :  ['ठ', '्', 'र', 'ा'] 

ठ्रि  :  ['ठ', '्', 'र', 'ि'] 

ठ्री  :  ['ठ', '्', 'र', 'ी'] 

ठ्रु  :  ['ठ', '्', 'र', 'ु'] 

ठ्रू  :  ['ठ', '्', 'र', 'ू'] 

ठ्रे  :  ['ठ', '्', 'र', 'े'] 

ठ्रै  :  ['ठ', '्', 'र', 'ै'] 

ठ्रो  :  ['ठ', '्', 'र', 'ो'] 

ठ्रौ  :  ['ठ', '्', 'र', 'ौ'] 

ठ्रं  :  ['ठ', '्', 'र', 'ं'] 

ठ्रः  :  ['ठ', '्', 'र', 'ः'] 

र्ठ्  :  ['र', '्', 'ठ', '्'] 

र्ठ  :  ['र', '्', 'ठ'] 

र्ठा  :  ['र', '्', 'ठ', 'ा'] 

र्ठि  :  ['र', '्', 'ठ', 'ि'] 

र्ठी  :  ['र', '्', 'ठ', 'ी'] 

र्ठु  :  ['र', '्', 'ठ', 'ु'] 

र्ठू  :  ['र', '्', 'ठ', 'ू'] 

र्ठे  :  ['र', '्', 'ठ', 'े'] 

र्ठै  :  ['र', '्', 'ठ', 'ै'] 

र्ठो  :  ['र', '्', 'ठ', 'ो'] 

र्ठौ  :  ['र', '्', 'ठ', 'ौ'] 

र्ठं  :  ['र', '्', 'ठ', 'ं'] 

र्ठः  :  ['र', '्', 'ठ', 'ः'] 

ड्  :  ['ड', '्'] 

ड  :  ['ड'] 

डा  :  ['ड', 'ा'] 

डि  :  ['ड', 'ि'] 

डी  :  ['ड', 'ी'] 

डु  :  ['ड', 'ु'] 

डू  :  ['ड', 'ू'] 

डे  :  ['ड', 'े'] 

डै  :  ['ड', 'ै'] 

डो  :  ['ड', 'ो'] 

डौ  :  ['ड', 'ौ'] 

डं  :  ['ड', 'ं'] 

डः  :  ['ड', 'ः'] 

डृ्  :  ['ड', 'ृ', '्'] 

डृ  :  ['ड', 'ृ'] 

डृा  :  ['ड', 'ृ', 'ा'] 

डृि  :  ['ड', 'ृ', 'ि'] 

डृी  :  ['ड', 'ृ', 'ी'] 

डृु  :  ['ड', 'ृ', 'ु'] 

डृू  :  ['ड', 'ृ', 'ू'] 

डृे  :  ['ड', 'ृ', 'े'] 

डृै  :  ['ड', 'ृ', 'ै'] 

डृो  :  ['ड', 'ृ', 'ो'] 

डृौ  :  ['ड', 'ृ', 'ौ'] 

डृं  :  ['ड', 'ृ', 'ं'] 

डृः  :  ['ड', 'ृ', 'ः'] 

ड्र्  :  ['ड', '्', 'र', '्'] 

ड्र  :  ['ड', '्', 'र'] 

ड्रा  :  ['ड', '्', 'र', 'ा'] 

ड्रि  :  ['ड', '्', 'र', 'ि'] 

ड्री  :  ['ड', '्', 'र', 'ी'] 

ड्रु  :  ['ड', '्', 'र', 'ु'] 

ड्रू  :  ['ड', '्', 'र', 'ू'] 

ड्रे  :  ['ड', '्', 'र', 'े'] 

ड्रै  :  ['ड', '्', 'र', 'ै'] 

ड्रो  :  ['ड', '्', 'र', 'ो'] 

ड्रौ  :  ['ड', '्', 'र', 'ौ'] 

ड्रं  :  ['ड', '्', 'र', 'ं'] 

ड्रः  :  ['ड', '्', 'र', 'ः'] 

र्ड्  :  ['र', '्', 'ड', '्'] 

र्ड  :  ['र', '्', 'ड'] 

र्डा  :  ['र', '्', 'ड', 'ा'] 

र्डि  :  ['र', '्', 'ड', 'ि'] 

र्डी  :  ['र', '्', 'ड', 'ी'] 

र्डु  :  ['र', '्', 'ड', 'ु'] 

र्डू  :  ['र', '्', 'ड', 'ू'] 

र्डे  :  ['र', '्', 'ड', 'े'] 

र्डै  :  ['र', '्', 'ड', 'ै'] 

र्डो  :  ['र', '्', 'ड', 'ो'] 

र्डौ  :  ['र', '्', 'ड', 'ौ'] 

र्डं  :  ['र', '्', 'ड', 'ं'] 

र्डः  :  ['र', '्', 'ड', 'ः'] 

ढ्  :  ['ढ', '्'] 

ढ  :  ['ढ'] 

ढा  :  ['ढ', 'ा'] 

ढि  :  ['ढ', 'ि'] 

ढी  :  ['ढ', 'ी'] 

ढु  :  ['ढ', 'ु'] 

ढू  :  ['ढ', 'ू'] 

ढे  :  ['ढ', 'े'] 

ढै  :  ['ढ', 'ै'] 

ढो  :  ['ढ', 'ो'] 

ढौ  :  ['ढ', 'ौ'] 

ढं  :  ['ढ', 'ं'] 

ढः  :  ['ढ', 'ः'] 

ढृ्  :  ['ढ', 'ृ', '्'] 

ढृ  :  ['ढ', 'ृ'] 

ढृा  :  ['ढ', 'ृ', 'ा'] 

ढृि  :  ['ढ', 'ृ', 'ि'] 

ढृी  :  ['ढ', 'ृ', 'ी'] 

ढृु  :  ['ढ', 'ृ', 'ु'] 

ढृू  :  ['ढ', 'ृ', 'ू'] 

ढृे  :  ['ढ', 'ृ', 'े'] 

ढृै  :  ['ढ', 'ृ', 'ै'] 

ढृो  :  ['ढ', 'ृ', 'ो'] 

ढृौ  :  ['ढ', 'ृ', 'ौ'] 

ढृं  :  ['ढ', 'ृ', 'ं'] 

ढृः  :  ['ढ', 'ृ', 'ः'] 

ढ्र्  :  ['ढ', '्', 'र', '्'] 

ढ्र  :  ['ढ', '्', 'र'] 

ढ्रा  :  ['ढ', '्', 'र', 'ा'] 

ढ्रि  :  ['ढ', '्', 'र', 'ि'] 

ढ्री  :  ['ढ', '्', 'र', 'ी'] 

ढ्रु  :  ['ढ', '्', 'र', 'ु'] 

ढ्रू  :  ['ढ', '्', 'र', 'ू'] 

ढ्रे  :  ['ढ', '्', 'र', 'े'] 

ढ्रै  :  ['ढ', '्', 'र', 'ै'] 

ढ्रो  :  ['ढ', '्', 'र', 'ो'] 

ढ्रौ  :  ['ढ', '्', 'र', 'ौ'] 

ढ्रं  :  ['ढ', '्', 'र', 'ं'] 

ढ्रः  :  ['ढ', '्', 'र', 'ः'] 

र्ढ्  :  ['र', '्', 'ढ', '्'] 

र्ढ  :  ['र', '्', 'ढ'] 

र्ढा  :  ['र', '्', 'ढ', 'ा'] 

र्ढि  :  ['र', '्', 'ढ', 'ि'] 

र्ढी  :  ['र', '्', 'ढ', 'ी'] 

र्ढु  :  ['र', '्', 'ढ', 'ु'] 

र्ढू  :  ['र', '्', 'ढ', 'ू'] 

र्ढे  :  ['र', '्', 'ढ', 'े'] 

र्ढै  :  ['र', '्', 'ढ', 'ै'] 

र्ढो  :  ['र', '्', 'ढ', 'ो'] 

र्ढौ  :  ['र', '्', 'ढ', 'ौ'] 

र्ढं  :  ['र', '्', 'ढ', 'ं'] 

र्ढः  :  ['र', '्', 'ढ', 'ः'] 

ण्  :  ['ण', '्'] 

ण  :  ['ण'] 

णा  :  ['ण', 'ा'] 

णि  :  ['ण', 'ि'] 

णी  :  ['ण', 'ी'] 

णु  :  ['ण', 'ु'] 

णू  :  ['ण', 'ू'] 

णे  :  ['ण', 'े'] 

णै  :  ['ण', 'ै'] 

णो  :  ['ण', 'ो'] 

णौ  :  ['ण', 'ौ'] 

णं  :  ['ण', 'ं'] 

णः  :  ['ण', 'ः'] 

णृ्  :  ['ण', 'ृ', '्'] 

णृ  :  ['ण', 'ृ'] 

णृा  :  ['ण', 'ृ', 'ा'] 

णृि  :  ['ण', 'ृ', 'ि'] 

णृी  :  ['ण', 'ृ', 'ी'] 

णृु  :  ['ण', 'ृ', 'ु'] 

णृू  :  ['ण', 'ृ', 'ू'] 

णृे  :  ['ण', 'ृ', 'े'] 

णृै  :  ['ण', 'ृ', 'ै'] 

णृो  :  ['ण', 'ृ', 'ो'] 

णृौ  :  ['ण', 'ृ', 'ौ'] 

णृं  :  ['ण', 'ृ', 'ं'] 

णृः  :  ['ण', 'ृ', 'ः'] 

ण्र्  :  ['ण', '्', 'र', '्'] 

ण्र  :  ['ण', '्', 'र'] 

ण्रा  :  ['ण', '्', 'र', 'ा'] 

ण्रि  :  ['ण', '्', 'र', 'ि'] 

ण्री  :  ['ण', '्', 'र', 'ी'] 

ण्रु  :  ['ण', '्', 'र', 'ु'] 

ण्रू  :  ['ण', '्', 'र', 'ू'] 

ण्रे  :  ['ण', '्', 'र', 'े'] 

ण्रै  :  ['ण', '्', 'र', 'ै'] 

ण्रो  :  ['ण', '्', 'र', 'ो'] 

ण्रौ  :  ['ण', '्', 'र', 'ौ'] 

ण्रं  :  ['ण', '्', 'र', 'ं'] 

ण्रः  :  ['ण', '्', 'र', 'ः'] 

र्ण्  :  ['र', '्', 'ण', '्'] 

र्ण  :  ['र', '्', 'ण'] 

र्णा  :  ['र', '्', 'ण', 'ा'] 

र्णि  :  ['र', '्', 'ण', 'ि'] 

र्णी  :  ['र', '्', 'ण', 'ी'] 

र्णु  :  ['र', '्', 'ण', 'ु'] 

र्णू  :  ['र', '्', 'ण', 'ू'] 

र्णे  :  ['र', '्', 'ण', 'े'] 

र्णै  :  ['र', '्', 'ण', 'ै'] 

र्णो  :  ['र', '्', 'ण', 'ो'] 

र्णौ  :  ['र', '्', 'ण', 'ौ'] 

र्णं  :  ['र', '्', 'ण', 'ं'] 

र्णः  :  ['र', '्', 'ण', 'ः'] 

च्  :  ['च', '्'] 

च  :  ['च'] 

चा  :  ['च', 'ा'] 

चि  :  ['च', 'ि'] 

ची  :  ['च', 'ी'] 

चु  :  ['च', 'ु'] 

चू  :  ['च', 'ू'] 

चे  :  ['च', 'े'] 

चै  :  ['च', 'ै'] 

चो  :  ['च', 'ो'] 

चौ  :  ['च', 'ौ'] 

चं  :  ['च', 'ं'] 

चः  :  ['च', 'ः'] 

चृ्  :  ['च', 'ृ', '्'] 

चृ  :  ['च', 'ृ'] 

चृा  :  ['च', 'ृ', 'ा'] 

चृि  :  ['च', 'ृ', 'ि'] 

चृी  :  ['च', 'ृ', 'ी'] 

चृु  :  ['च', 'ृ', 'ु'] 

चृू  :  ['च', 'ृ', 'ू'] 

चृे  :  ['च', 'ृ', 'े'] 

चृै  :  ['च', 'ृ', 'ै'] 

चृो  :  ['च', 'ृ', 'ो'] 

चृौ  :  ['च', 'ृ', 'ौ'] 

चृं  :  ['च', 'ृ', 'ं'] 

चृः  :  ['च', 'ृ', 'ः'] 

च्र्  :  ['च', '्', 'र', '्'] 

च्र  :  ['च', '्', 'र'] 

च्रा  :  ['च', '्', 'र', 'ा'] 

च्रि  :  ['च', '्', 'र', 'ि'] 

च्री  :  ['च', '्', 'र', 'ी'] 

च्रु  :  ['च', '्', 'र', 'ु'] 

च्रू  :  ['च', '्', 'र', 'ू'] 

च्रे  :  ['च', '्', 'र', 'े'] 

च्रै  :  ['च', '्', 'र', 'ै'] 

च्रो  :  ['च', '्', 'र', 'ो'] 

च्रौ  :  ['च', '्', 'र', 'ौ'] 

च्रं  :  ['च', '्', 'र', 'ं'] 

च्रः  :  ['च', '्', 'र', 'ः'] 

र्च्  :  ['र', '्', 'च', '्'] 

र्च  :  ['र', '्', 'च'] 

र्चा  :  ['र', '्', 'च', 'ा'] 

र्चि  :  ['र', '्', 'च', 'ि'] 

र्ची  :  ['र', '्', 'च', 'ी'] 

र्चु  :  ['र', '्', 'च', 'ु'] 

र्चू  :  ['र', '्', 'च', 'ू'] 

र्चे  :  ['र', '्', 'च', 'े'] 

र्चै  :  ['र', '्', 'च', 'ै'] 

र्चो  :  ['र', '्', 'च', 'ो'] 

र्चौ  :  ['र', '्', 'च', 'ौ'] 

र्चं  :  ['र', '्', 'च', 'ं'] 

र्चः  :  ['र', '्', 'च', 'ः'] 

छ्  :  ['छ', '्'] 

छ  :  ['छ'] 

छा  :  ['छ', 'ा'] 

छि  :  ['छ', 'ि'] 

छी  :  ['छ', 'ी'] 

छु  :  ['छ', 'ु'] 

छू  :  ['छ', 'ू'] 

छे  :  ['छ', 'े'] 

छै  :  ['छ', 'ै'] 

छो  :  ['छ', 'ो'] 

छौ  :  ['छ', 'ौ'] 

छं  :  ['छ', 'ं'] 

छः  :  ['छ', 'ः'] 

छृ्  :  ['छ', 'ृ', '्'] 

छृ  :  ['छ', 'ृ'] 

छृा  :  ['छ', 'ृ', 'ा'] 

छृि  :  ['छ', 'ृ', 'ि'] 

छृी  :  ['छ', 'ृ', 'ी'] 

छृु  :  ['छ', 'ृ', 'ु'] 

छृू  :  ['छ', 'ृ', 'ू'] 

छृे  :  ['छ', 'ृ', 'े'] 

छृै  :  ['छ', 'ृ', 'ै'] 

छृो  :  ['छ', 'ृ', 'ो'] 

छृौ  :  ['छ', 'ृ', 'ौ'] 

छृं  :  ['छ', 'ृ', 'ं'] 

छृः  :  ['छ', 'ृ', 'ः'] 

छ्र्  :  ['छ', '्', 'र', '्'] 

छ्र  :  ['छ', '्', 'र'] 

छ्रा  :  ['छ', '्', 'र', 'ा'] 

छ्रि  :  ['छ', '्', 'र', 'ि'] 

छ्री  :  ['छ', '्', 'र', 'ी'] 

छ्रु  :  ['छ', '्', 'र', 'ु'] 

छ्रू  :  ['छ', '्', 'र', 'ू'] 

छ्रे  :  ['छ', '्', 'र', 'े'] 

छ्रै  :  ['छ', '्', 'र', 'ै'] 

छ्रो  :  ['छ', '्', 'र', 'ो'] 

छ्रौ  :  ['छ', '्', 'र', 'ौ'] 

छ्रं  :  ['छ', '्', 'र', 'ं'] 

छ्रः  :  ['छ', '्', 'र', 'ः'] 

र्छ्  :  ['र', '्', 'छ', '्'] 

र्छ  :  ['र', '्', 'छ'] 

र्छा  :  ['र', '्', 'छ', 'ा'] 

र्छि  :  ['र', '्', 'छ', 'ि'] 

र्छी  :  ['र', '्', 'छ', 'ी'] 

र्छु  :  ['र', '्', 'छ', 'ु'] 

र्छू  :  ['र', '्', 'छ', 'ू'] 

र्छे  :  ['र', '्', 'छ', 'े'] 

र्छै  :  ['र', '्', 'छ', 'ै'] 

र्छो  :  ['र', '्', 'छ', 'ो'] 

र्छौ  :  ['र', '्', 'छ', 'ौ'] 

र्छं  :  ['र', '्', 'छ', 'ं'] 

र्छः  :  ['र', '्', 'छ', 'ः'] 

ज्  :  ['ज', '्'] 

ज  :  ['ज'] 

जा  :  ['ज', 'ा'] 

जि  :  ['ज', 'ि'] 

जी  :  ['ज', 'ी'] 

जु  :  ['ज', 'ु'] 

जू  :  ['ज', 'ू'] 

जे  :  ['ज', 'े'] 

जै  :  ['ज', 'ै'] 

जो  :  ['ज', 'ो'] 

जौ  :  ['ज', 'ौ'] 

जं  :  ['ज', 'ं'] 

जः  :  ['ज', 'ः'] 

जृ्  :  ['ज', 'ृ', '्'] 

जृ  :  ['ज', 'ृ'] 

जृा  :  ['ज', 'ृ', 'ा'] 

जृि  :  ['ज', 'ृ', 'ि'] 

जृी  :  ['ज', 'ृ', 'ी'] 

जृु  :  ['ज', 'ृ', 'ु'] 

जृू  :  ['ज', 'ृ', 'ू'] 

जृे  :  ['ज', 'ृ', 'े'] 

जृै  :  ['ज', 'ृ', 'ै'] 

जृो  :  ['ज', 'ृ', 'ो'] 

जृौ  :  ['ज', 'ृ', 'ौ'] 

जृं  :  ['ज', 'ृ', 'ं'] 

जृः  :  ['ज', 'ृ', 'ः'] 

ज्र्  :  ['ज', '्', 'र', '्'] 

ज्र  :  ['ज', '्', 'र'] 

ज्रा  :  ['ज', '्', 'र', 'ा'] 

ज्रि  :  ['ज', '्', 'र', 'ि'] 

ज्री  :  ['ज', '्', 'र', 'ी'] 

ज्रु  :  ['ज', '्', 'र', 'ु'] 

ज्रू  :  ['ज', '्', 'र', 'ू'] 

ज्रे  :  ['ज', '्', 'र', 'े'] 

ज्रै  :  ['ज', '्', 'र', 'ै'] 

ज्रो  :  ['ज', '्', 'र', 'ो'] 

ज्रौ  :  ['ज', '्', 'र', 'ौ'] 

ज्रं  :  ['ज', '्', 'र', 'ं'] 

ज्रः  :  ['ज', '्', 'र', 'ः'] 

र्ज्  :  ['र', '्', 'ज', '्'] 

र्ज  :  ['र', '्', 'ज'] 

र्जा  :  ['र', '्', 'ज', 'ा'] 

र्जि  :  ['र', '्', 'ज', 'ि'] 

र्जी  :  ['र', '्', 'ज', 'ी'] 

र्जु  :  ['र', '्', 'ज', 'ु'] 

र्जू  :  ['र', '्', 'ज', 'ू'] 

र्जे  :  ['र', '्', 'ज', 'े'] 

र्जै  :  ['र', '्', 'ज', 'ै'] 

र्जो  :  ['र', '्', 'ज', 'ो'] 

र्जौ  :  ['र', '्', 'ज', 'ौ'] 

र्जं  :  ['र', '्', 'ज', 'ं'] 

र्जः  :  ['र', '्', 'ज', 'ः'] 

झ्  :  ['झ', '्'] 

झ  :  ['झ'] 

झा  :  ['झ', 'ा'] 

झि  :  ['झ', 'ि'] 

झी  :  ['झ', 'ी'] 

झु  :  ['झ', 'ु'] 

झू  :  ['झ', 'ू'] 

झे  :  ['झ', 'े'] 

झै  :  ['झ', 'ै'] 

झो  :  ['झ', 'ो'] 

झौ  :  ['झ', 'ौ'] 

झं  :  ['झ', 'ं'] 

झः  :  ['झ', 'ः'] 

झृ्  :  ['झ', 'ृ', '्'] 

झृ  :  ['झ', 'ृ'] 

झृा  :  ['झ', 'ृ', 'ा'] 

झृि  :  ['झ', 'ृ', 'ि'] 

झृी  :  ['झ', 'ृ', 'ी'] 

झृु  :  ['झ', 'ृ', 'ु'] 

झृू  :  ['झ', 'ृ', 'ू'] 

झृे  :  ['झ', 'ृ', 'े'] 

झृै  :  ['झ', 'ृ', 'ै'] 

झृो  :  ['झ', 'ृ', 'ो'] 

झृौ  :  ['झ', 'ृ', 'ौ'] 

झृं  :  ['झ', 'ृ', 'ं'] 

झृः  :  ['झ', 'ृ', 'ः'] 

झ्र्  :  ['झ', '्', 'र', '्'] 

झ्र  :  ['झ', '्', 'र'] 

झ्रा  :  ['झ', '्', 'र', 'ा'] 

झ्रि  :  ['झ', '्', 'र', 'ि'] 

झ्री  :  ['झ', '्', 'र', 'ी'] 

झ्रु  :  ['झ', '्', 'र', 'ु'] 

झ्रू  :  ['झ', '्', 'र', 'ू'] 

झ्रे  :  ['झ', '्', 'र', 'े'] 

झ्रै  :  ['झ', '्', 'र', 'ै'] 

झ्रो  :  ['झ', '्', 'र', 'ो'] 

झ्रौ  :  ['झ', '्', 'र', 'ौ'] 

झ्रं  :  ['झ', '्', 'र', 'ं'] 

झ्रः  :  ['झ', '्', 'र', 'ः'] 

र्झ्  :  ['र', '्', 'झ', '्'] 

र्झ  :  ['र', '्', 'झ'] 

र्झा  :  ['र', '्', 'झ', 'ा'] 

र्झि  :  ['र', '्', 'झ', 'ि'] 

र्झी  :  ['र', '्', 'झ', 'ी'] 

र्झु  :  ['र', '्', 'झ', 'ु'] 

र्झू  :  ['र', '्', 'झ', 'ू'] 

र्झे  :  ['र', '्', 'झ', 'े'] 

र्झै  :  ['र', '्', 'झ', 'ै'] 

र्झो  :  ['र', '्', 'झ', 'ो'] 

र्झौ  :  ['र', '्', 'झ', 'ौ'] 

र्झं  :  ['र', '्', 'झ', 'ं'] 

र्झः  :  ['र', '्', 'झ', 'ः'] 

ञ्  :  ['ञ', '्'] 

ञ  :  ['ञ'] 

ञा  :  ['ञ', 'ा'] 

ञि  :  ['ञ', 'ि'] 

ञी  :  ['ञ', 'ी'] 

ञु  :  ['ञ', 'ु'] 

ञू  :  ['ञ', 'ू'] 

ञे  :  ['ञ', 'े'] 

ञै  :  ['ञ', 'ै'] 

ञो  :  ['ञ', 'ो'] 

ञौ  :  ['ञ', 'ौ'] 

ञं  :  ['ञ', 'ं'] 

ञः  :  ['ञ', 'ः'] 

ञृ्  :  ['ञ', 'ृ', '्'] 

ञृ  :  ['ञ', 'ृ'] 

ञृा  :  ['ञ', 'ृ', 'ा'] 

ञृि  :  ['ञ', 'ृ', 'ि'] 

ञृी  :  ['ञ', 'ृ', 'ी'] 

ञृु  :  ['ञ', 'ृ', 'ु'] 

ञृू  :  ['ञ', 'ृ', 'ू'] 

ञृे  :  ['ञ', 'ृ', 'े'] 

ञृै  :  ['ञ', 'ृ', 'ै'] 

ञृो  :  ['ञ', 'ृ', 'ो'] 

ञृौ  :  ['ञ', 'ृ', 'ौ'] 

ञृं  :  ['ञ', 'ृ', 'ं'] 

ञृः  :  ['ञ', 'ृ', 'ः'] 

ञ्र्  :  ['ञ', '्', 'र', '्'] 

ञ्र  :  ['ञ', '्', 'र'] 

ञ्रा  :  ['ञ', '्', 'र', 'ा'] 

ञ्रि  :  ['ञ', '्', 'र', 'ि'] 

ञ्री  :  ['ञ', '्', 'र', 'ी'] 

ञ्रु  :  ['ञ', '्', 'र', 'ु'] 

ञ्रू  :  ['ञ', '्', 'र', 'ू'] 

ञ्रे  :  ['ञ', '्', 'र', 'े'] 

ञ्रै  :  ['ञ', '्', 'र', 'ै'] 

ञ्रो  :  ['ञ', '्', 'र', 'ो'] 

ञ्रौ  :  ['ञ', '्', 'र', 'ौ'] 

ञ्रं  :  ['ञ', '्', 'र', 'ं'] 

ञ्रः  :  ['ञ', '्', 'र', 'ः'] 

र्ञ्  :  ['र', '्', 'ञ', '्'] 

र्ञ  :  ['र', '्', 'ञ'] 

र्ञा  :  ['र', '्', 'ञ', 'ा'] 

र्ञि  :  ['र', '्', 'ञ', 'ि'] 

र्ञी  :  ['र', '्', 'ञ', 'ी'] 

र्ञु  :  ['र', '्', 'ञ', 'ु'] 

र्ञू  :  ['र', '्', 'ञ', 'ू'] 

र्ञे  :  ['र', '्', 'ञ', 'े'] 

र्ञै  :  ['र', '्', 'ञ', 'ै'] 

र्ञो  :  ['र', '्', 'ञ', 'ो'] 

र्ञौ  :  ['र', '्', 'ञ', 'ौ'] 

र्ञं  :  ['र', '्', 'ञ', 'ं'] 

र्ञः  :  ['र', '्', 'ञ', 'ः'] 

त्  :  ['त', '्'] 

त  :  ['त'] 

ता  :  ['त', 'ा'] 

ति  :  ['त', 'ि'] 

ती  :  ['त', 'ी'] 

तु  :  ['त', 'ु'] 

तू  :  ['त', 'ू'] 

ते  :  ['त', 'े'] 

तै  :  ['त', 'ै'] 

तो  :  ['त', 'ो'] 

तौ  :  ['त', 'ौ'] 

तं  :  ['त', 'ं'] 

तः  :  ['त', 'ः'] 

तृ्  :  ['त', 'ृ', '्'] 

तृ  :  ['त', 'ृ'] 

तृा  :  ['त', 'ृ', 'ा'] 

तृि  :  ['त', 'ृ', 'ि'] 

तृी  :  ['त', 'ृ', 'ी'] 

तृु  :  ['त', 'ृ', 'ु'] 

तृू  :  ['त', 'ृ', 'ू'] 

तृे  :  ['त', 'ृ', 'े'] 

तृै  :  ['त', 'ृ', 'ै'] 

तृो  :  ['त', 'ृ', 'ो'] 

तृौ  :  ['त', 'ृ', 'ौ'] 

तृं  :  ['त', 'ृ', 'ं'] 

तृः  :  ['त', 'ृ', 'ः'] 

र्त्  :  ['र', '्', 'त', '्'] 

र्त  :  ['र', '्', 'त'] 

र्ता  :  ['र', '्', 'त', 'ा'] 

र्ति  :  ['र', '्', 'त', 'ि'] 

र्ती  :  ['र', '्', 'त', 'ी'] 

र्तु  :  ['र', '्', 'त', 'ु'] 

र्तू  :  ['र', '्', 'त', 'ू'] 

र्ते  :  ['र', '्', 'त', 'े'] 

र्तै  :  ['र', '्', 'त', 'ै'] 

र्तो  :  ['र', '्', 'त', 'ो'] 

र्तौ  :  ['र', '्', 'त', 'ौ'] 

र्तं  :  ['र', '्', 'त', 'ं'] 

र्तः  :  ['र', '्', 'त', 'ः'] 

थ्  :  ['थ', '्'] 

थ  :  ['थ'] 

था  :  ['थ', 'ा'] 

थि  :  ['थ', 'ि'] 

थी  :  ['थ', 'ी'] 

थु  :  ['थ', 'ु'] 

थू  :  ['थ', 'ू'] 

थे  :  ['थ', 'े'] 

थै  :  ['थ', 'ै'] 

थो  :  ['थ', 'ो'] 

थौ  :  ['थ', 'ौ'] 

थं  :  ['थ', 'ं'] 

थः  :  ['थ', 'ः'] 

थृ्  :  ['थ', 'ृ', '्'] 

थृ  :  ['थ', 'ृ'] 

थृा  :  ['थ', 'ृ', 'ा'] 

थृि  :  ['थ', 'ृ', 'ि'] 

थृी  :  ['थ', 'ृ', 'ी'] 

थृु  :  ['थ', 'ृ', 'ु'] 

थृू  :  ['थ', 'ृ', 'ू'] 

थृे  :  ['थ', 'ृ', 'े'] 

थृै  :  ['थ', 'ृ', 'ै'] 

थृो  :  ['थ', 'ृ', 'ो'] 

थृौ  :  ['थ', 'ृ', 'ौ'] 

थृं  :  ['थ', 'ृ', 'ं'] 

थृः  :  ['थ', 'ृ', 'ः'] 

थ्र्  :  ['थ', '्', 'र', '्'] 

थ्र  :  ['थ', '्', 'र'] 

थ्रा  :  ['थ', '्', 'र', 'ा'] 

थ्रि  :  ['थ', '्', 'र', 'ि'] 

थ्री  :  ['थ', '्', 'र', 'ी'] 

थ्रु  :  ['थ', '्', 'र', 'ु'] 

थ्रू  :  ['थ', '्', 'र', 'ू'] 

थ्रे  :  ['थ', '्', 'र', 'े'] 

थ्रै  :  ['थ', '्', 'र', 'ै'] 

थ्रो  :  ['थ', '्', 'र', 'ो'] 

थ्रौ  :  ['थ', '्', 'र', 'ौ'] 

थ्रं  :  ['थ', '्', 'र', 'ं'] 

थ्रः  :  ['थ', '्', 'र', 'ः'] 

र्थ्  :  ['र', '्', 'थ', '्'] 

र्थ  :  ['र', '्', 'थ'] 

र्था  :  ['र', '्', 'थ', 'ा'] 

र्थि  :  ['र', '्', 'थ', 'ि'] 

र्थी  :  ['र', '्', 'थ', 'ी'] 

र्थु  :  ['र', '्', 'थ', 'ु'] 

र्थू  :  ['र', '्', 'थ', 'ू'] 

र्थे  :  ['र', '्', 'थ', 'े'] 

र्थै  :  ['र', '्', 'थ', 'ै'] 

र्थो  :  ['र', '्', 'थ', 'ो'] 

र्थौ  :  ['र', '्', 'थ', 'ौ'] 

र्थं  :  ['र', '्', 'थ', 'ं'] 

र्थः  :  ['र', '्', 'थ', 'ः'] 

द्  :  ['द', '्'] 

द  :  ['द'] 

दा  :  ['द', 'ा'] 

दि  :  ['द', 'ि'] 

दी  :  ['द', 'ी'] 

दु  :  ['द', 'ु'] 

दू  :  ['द', 'ू'] 

दे  :  ['द', 'े'] 

दै  :  ['द', 'ै'] 

दो  :  ['द', 'ो'] 

दौ  :  ['द', 'ौ'] 

दं  :  ['द', 'ं'] 

दः  :  ['द', 'ः'] 

दृ्  :  ['द', 'ृ', '्'] 

दृ  :  ['द', 'ृ'] 

दृा  :  ['द', 'ृ', 'ा'] 

दृि  :  ['द', 'ृ', 'ि'] 

दृी  :  ['द', 'ृ', 'ी'] 

दृु  :  ['द', 'ृ', 'ु'] 

दृू  :  ['द', 'ृ', 'ू'] 

दृे  :  ['द', 'ृ', 'े'] 

दृै  :  ['द', 'ृ', 'ै'] 

दृो  :  ['द', 'ृ', 'ो'] 

दृौ  :  ['द', 'ृ', 'ौ'] 

दृं  :  ['द', 'ृ', 'ं'] 

दृः  :  ['द', 'ृ', 'ः'] 

द्र्  :  ['द', '्', 'र', '्'] 

द्र  :  ['द', '्', 'र'] 

द्रा  :  ['द', '्', 'र', 'ा'] 

द्रि  :  ['द', '्', 'र', 'ि'] 

द्री  :  ['द', '्', 'र', 'ी'] 

द्रु  :  ['द', '्', 'र', 'ु'] 

द्रू  :  ['द', '्', 'र', 'ू'] 

द्रे  :  ['द', '्', 'र', 'े'] 

द्रै  :  ['द', '्', 'र', 'ै'] 

द्रो  :  ['द', '्', 'र', 'ो'] 

द्रौ  :  ['द', '्', 'र', 'ौ'] 

द्रं  :  ['द', '्', 'र', 'ं'] 

द्रः  :  ['द', '्', 'र', 'ः'] 

र्द्  :  ['र', '्', 'द', '्'] 

र्द  :  ['र', '्', 'द'] 

र्दा  :  ['र', '्', 'द', 'ा'] 

र्दि  :  ['र', '्', 'द', 'ि'] 

र्दी  :  ['र', '्', 'द', 'ी'] 

र्दु  :  ['र', '्', 'द', 'ु'] 

र्दू  :  ['र', '्', 'द', 'ू'] 

र्दे  :  ['र', '्', 'द', 'े'] 

र्दै  :  ['र', '्', 'द', 'ै'] 

र्दो  :  ['र', '्', 'द', 'ो'] 

र्दौ  :  ['र', '्', 'द', 'ौ'] 

र्दं  :  ['र', '्', 'द', 'ं'] 

र्दः  :  ['र', '्', 'द', 'ः'] 

ध्  :  ['ध', '्'] 

ध  :  ['ध'] 

धा  :  ['ध', 'ा'] 

धि  :  ['ध', 'ि'] 

धी  :  ['ध', 'ी'] 

धु  :  ['ध', 'ु'] 

धू  :  ['ध', 'ू'] 

धे  :  ['ध', 'े'] 

धै  :  ['ध', 'ै'] 

धो  :  ['ध', 'ो'] 

धौ  :  ['ध', 'ौ'] 

धं  :  ['ध', 'ं'] 

धः  :  ['ध', 'ः'] 

धृ्  :  ['ध', 'ृ', '्'] 

धृ  :  ['ध', 'ृ'] 

धृा  :  ['ध', 'ृ', 'ा'] 

धृि  :  ['ध', 'ृ', 'ि'] 

धृी  :  ['ध', 'ृ', 'ी'] 

धृु  :  ['ध', 'ृ', 'ु'] 

धृू  :  ['ध', 'ृ', 'ू'] 

धृे  :  ['ध', 'ृ', 'े'] 

धृै  :  ['ध', 'ृ', 'ै'] 

धृो  :  ['ध', 'ृ', 'ो'] 

धृौ  :  ['ध', 'ृ', 'ौ'] 

धृं  :  ['ध', 'ृ', 'ं'] 

धृः  :  ['ध', 'ृ', 'ः'] 

ध्र्  :  ['ध', '्', 'र', '्'] 

ध्र  :  ['ध', '्', 'र'] 

ध्रा  :  ['ध', '्', 'र', 'ा'] 

ध्रि  :  ['ध', '्', 'र', 'ि'] 

ध्री  :  ['ध', '्', 'र', 'ी'] 

ध्रु  :  ['ध', '्', 'र', 'ु'] 

ध्रू  :  ['ध', '्', 'र', 'ू'] 

ध्रे  :  ['ध', '्', 'र', 'े'] 

ध्रै  :  ['ध', '्', 'र', 'ै'] 

ध्रो  :  ['ध', '्', 'र', 'ो'] 

ध्रौ  :  ['ध', '्', 'र', 'ौ'] 

ध्रं  :  ['ध', '्', 'र', 'ं'] 

ध्रः  :  ['ध', '्', 'र', 'ः'] 

र्ध्  :  ['र', '्', 'ध', '्'] 

र्ध  :  ['र', '्', 'ध'] 

र्धा  :  ['र', '्', 'ध', 'ा'] 

र्धि  :  ['र', '्', 'ध', 'ि'] 

र्धी  :  ['र', '्', 'ध', 'ी'] 

र्धु  :  ['र', '्', 'ध', 'ु'] 

र्धू  :  ['र', '्', 'ध', 'ू'] 

र्धे  :  ['र', '्', 'ध', 'े'] 

र्धै  :  ['र', '्', 'ध', 'ै'] 

र्धो  :  ['र', '्', 'ध', 'ो'] 

र्धौ  :  ['र', '्', 'ध', 'ौ'] 

र्धं  :  ['र', '्', 'ध', 'ं'] 

र्धः  :  ['र', '्', 'ध', 'ः'] 

न्  :  ['न', '्'] 

न  :  ['न'] 

ना  :  ['न', 'ा'] 

नि  :  ['न', 'ि'] 

नी  :  ['न', 'ी'] 

नु  :  ['न', 'ु'] 

नू  :  ['न', 'ू'] 

ने  :  ['न', 'े'] 

नै  :  ['न', 'ै'] 

नो  :  ['न', 'ो'] 

नौ  :  ['न', 'ौ'] 

नं  :  ['न', 'ं'] 

नः  :  ['न', 'ः'] 

नृ्  :  ['न', 'ृ', '्'] 

नृ  :  ['न', 'ृ'] 

नृा  :  ['न', 'ृ', 'ा'] 

नृि  :  ['न', 'ृ', 'ि'] 

नृी  :  ['न', 'ृ', 'ी'] 

नृु  :  ['न', 'ृ', 'ु'] 

नृू  :  ['न', 'ृ', 'ू'] 

नृे  :  ['न', 'ृ', 'े'] 

नृै  :  ['न', 'ृ', 'ै'] 

नृो  :  ['न', 'ृ', 'ो'] 

नृौ  :  ['न', 'ृ', 'ौ'] 

नृं  :  ['न', 'ृ', 'ं'] 

नृः  :  ['न', 'ृ', 'ः'] 

न्र्  :  ['न', '्', 'र', '्'] 

न्र  :  ['न', '्', 'र'] 

न्रा  :  ['न', '्', 'र', 'ा'] 

न्रि  :  ['न', '्', 'र', 'ि'] 

न्री  :  ['न', '्', 'र', 'ी'] 

न्रु  :  ['न', '्', 'र', 'ु'] 

न्रू  :  ['न', '्', 'र', 'ू'] 

न्रे  :  ['न', '्', 'र', 'े'] 

न्रै  :  ['न', '्', 'र', 'ै'] 

न्रो  :  ['न', '्', 'र', 'ो'] 

न्रौ  :  ['न', '्', 'र', 'ौ'] 

न्रं  :  ['न', '्', 'र', 'ं'] 

न्रः  :  ['न', '्', 'र', 'ः'] 

र्न्  :  ['र', '्', 'न', '्'] 

र्न  :  ['र', '्', 'न'] 

र्ना  :  ['र', '्', 'न', 'ा'] 

र्नि  :  ['र', '्', 'न', 'ि'] 

र्नी  :  ['र', '्', 'न', 'ी'] 

र्नु  :  ['र', '्', 'न', 'ु'] 

र्नू  :  ['र', '्', 'न', 'ू'] 

र्ने  :  ['र', '्', 'न', 'े'] 

र्नै  :  ['र', '्', 'न', 'ै'] 

र्नो  :  ['र', '्', 'न', 'ो'] 

र्नौ  :  ['र', '्', 'न', 'ौ'] 

र्नं  :  ['र', '्', 'न', 'ं'] 

र्नः  :  ['र', '्', 'न', 'ः'] 

प्  :  ['प', '्'] 

प  :  ['प'] 

पा  :  ['प', 'ा'] 

पि  :  ['प', 'ि'] 

पी  :  ['प', 'ी'] 

पु  :  ['प', 'ु'] 

पू  :  ['प', 'ू'] 

पे  :  ['प', 'े'] 

पै  :  ['प', 'ै'] 

पो  :  ['प', 'ो'] 

पौ  :  ['प', 'ौ'] 

पं  :  ['प', 'ं'] 

पः  :  ['प', 'ः'] 

पृ्  :  ['प', 'ृ', '्'] 

पृ  :  ['प', 'ृ'] 

पृा  :  ['प', 'ृ', 'ा'] 

पृि  :  ['प', 'ृ', 'ि'] 

पृी  :  ['प', 'ृ', 'ी'] 

पृु  :  ['प', 'ृ', 'ु'] 

पृू  :  ['प', 'ृ', 'ू'] 

पृे  :  ['प', 'ृ', 'े'] 

पृै  :  ['प', 'ृ', 'ै'] 

पृो  :  ['प', 'ृ', 'ो'] 

पृौ  :  ['प', 'ृ', 'ौ'] 

पृं  :  ['प', 'ृ', 'ं'] 

पृः  :  ['प', 'ृ', 'ः'] 

प्र्  :  ['प', '्', 'र', '्'] 

प्र  :  ['प', '्', 'र'] 

प्रा  :  ['प', '्', 'र', 'ा'] 

प्रि  :  ['प', '्', 'र', 'ि'] 

प्री  :  ['प', '्', 'र', 'ी'] 

प्रु  :  ['प', '्', 'र', 'ु'] 

प्रू  :  ['प', '्', 'र', 'ू'] 

प्रे  :  ['प', '्', 'र', 'े'] 

प्रै  :  ['प', '्', 'र', 'ै'] 

प्रो  :  ['प', '्', 'र', 'ो'] 

प्रौ  :  ['प', '्', 'र', 'ौ'] 

प्रं  :  ['प', '्', 'र', 'ं'] 

प्रः  :  ['प', '्', 'र', 'ः'] 

र्प्  :  ['र', '्', 'प', '्'] 

र्प  :  ['र', '्', 'प'] 

र्पा  :  ['र', '्', 'प', 'ा'] 

र्पि  :  ['र', '्', 'प', 'ि'] 

र्पी  :  ['र', '्', 'प', 'ी'] 

र्पु  :  ['र', '्', 'प', 'ु'] 

र्पू  :  ['र', '्', 'प', 'ू'] 

र्पे  :  ['र', '्', 'प', 'े'] 

र्पै  :  ['र', '्', 'प', 'ै'] 

र्पो  :  ['र', '्', 'प', 'ो'] 

र्पौ  :  ['र', '्', 'प', 'ौ'] 

र्पं  :  ['र', '्', 'प', 'ं'] 

र्पः  :  ['र', '्', 'प', 'ः'] 

फ्  :  ['फ', '्'] 

फ  :  ['फ'] 

फा  :  ['फ', 'ा'] 

फि  :  ['फ', 'ि'] 

फी  :  ['फ', 'ी'] 

फु  :  ['फ', 'ु'] 

फू  :  ['फ', 'ू'] 

फे  :  ['फ', 'े'] 

फै  :  ['फ', 'ै'] 

फो  :  ['फ', 'ो'] 

फौ  :  ['फ', 'ौ'] 

फं  :  ['फ', 'ं'] 

फः  :  ['फ', 'ः'] 

फृ्  :  ['फ', 'ृ', '्'] 

फृ  :  ['फ', 'ृ'] 

फृा  :  ['फ', 'ृ', 'ा'] 

फृि  :  ['फ', 'ृ', 'ि'] 

फृी  :  ['फ', 'ृ', 'ी'] 

फृु  :  ['फ', 'ृ', 'ु'] 

फृू  :  ['फ', 'ृ', 'ू'] 

फृे  :  ['फ', 'ृ', 'े'] 

फृै  :  ['फ', 'ृ', 'ै'] 

फृो  :  ['फ', 'ृ', 'ो'] 

फृौ  :  ['फ', 'ृ', 'ौ'] 

फृं  :  ['फ', 'ृ', 'ं'] 

फृः  :  ['फ', 'ृ', 'ः'] 

फ्र्  :  ['फ', '्', 'र', '्'] 

फ्र  :  ['फ', '्', 'र'] 

फ्रा  :  ['फ', '्', 'र', 'ा'] 

फ्रि  :  ['फ', '्', 'र', 'ि'] 

फ्री  :  ['फ', '्', 'र', 'ी'] 

फ्रु  :  ['फ', '्', 'र', 'ु'] 

फ्रू  :  ['फ', '्', 'र', 'ू'] 

फ्रे  :  ['फ', '्', 'र', 'े'] 

फ्रै  :  ['फ', '्', 'र', 'ै'] 

फ्रो  :  ['फ', '्', 'र', 'ो'] 

फ्रौ  :  ['फ', '्', 'र', 'ौ'] 

फ्रं  :  ['फ', '्', 'र', 'ं'] 

फ्रः  :  ['फ', '्', 'र', 'ः'] 

र्फ्  :  ['र', '्', 'फ', '्'] 

र्फ  :  ['र', '्', 'फ'] 

र्फा  :  ['र', '्', 'फ', 'ा'] 

र्फि  :  ['र', '्', 'फ', 'ि'] 

र्फी  :  ['र', '्', 'फ', 'ी'] 

र्फु  :  ['र', '्', 'फ', 'ु'] 

र्फू  :  ['र', '्', 'फ', 'ू'] 

र्फे  :  ['र', '्', 'फ', 'े'] 

र्फै  :  ['र', '्', 'फ', 'ै'] 

र्फो  :  ['र', '्', 'फ', 'ो'] 

र्फौ  :  ['र', '्', 'फ', 'ौ'] 

र्फं  :  ['र', '्', 'फ', 'ं'] 

र्फः  :  ['र', '्', 'फ', 'ः'] 

ब्  :  ['ब', '्'] 

ब  :  ['ब'] 

बा  :  ['ब', 'ा'] 

बि  :  ['ब', 'ि'] 

बी  :  ['ब', 'ी'] 

बु  :  ['ब', 'ु'] 

बू  :  ['ब', 'ू'] 

बे  :  ['ब', 'े'] 

बै  :  ['ब', 'ै'] 

बो  :  ['ब', 'ो'] 

बौ  :  ['ब', 'ौ'] 

बं  :  ['ब', 'ं'] 

बः  :  ['ब', 'ः'] 

बृ्  :  ['ब', 'ृ', '्'] 

बृ  :  ['ब', 'ृ'] 

बृा  :  ['ब', 'ृ', 'ा'] 

बृि  :  ['ब', 'ृ', 'ि'] 

बृी  :  ['ब', 'ृ', 'ी'] 

बृु  :  ['ब', 'ृ', 'ु'] 

बृू  :  ['ब', 'ृ', 'ू'] 

बृे  :  ['ब', 'ृ', 'े'] 

बृै  :  ['ब', 'ृ', 'ै'] 

बृो  :  ['ब', 'ृ', 'ो'] 

बृौ  :  ['ब', 'ृ', 'ौ'] 

बृं  :  ['ब', 'ृ', 'ं'] 

बृः  :  ['ब', 'ृ', 'ः'] 

ब्र्  :  ['ब', '्', 'र', '्'] 

ब्र  :  ['ब', '्', 'र'] 

ब्रा  :  ['ब', '्', 'र', 'ा'] 

ब्रि  :  ['ब', '्', 'र', 'ि'] 

ब्री  :  ['ब', '्', 'र', 'ी'] 

ब्रु  :  ['ब', '्', 'र', 'ु'] 

ब्रू  :  ['ब', '्', 'र', 'ू'] 

ब्रे  :  ['ब', '्', 'र', 'े'] 

ब्रै  :  ['ब', '्', 'र', 'ै'] 

ब्रो  :  ['ब', '्', 'र', 'ो'] 

ब्रौ  :  ['ब', '्', 'र', 'ौ'] 

ब्रं  :  ['ब', '्', 'र', 'ं'] 

ब्रः  :  ['ब', '्', 'र', 'ः'] 

र्ब्  :  ['र', '्', 'ब', '्'] 

र्ब  :  ['र', '्', 'ब'] 

र्बा  :  ['र', '्', 'ब', 'ा'] 

र्बि  :  ['र', '्', 'ब', 'ि'] 

र्बी  :  ['र', '्', 'ब', 'ी'] 

र्बु  :  ['र', '्', 'ब', 'ु'] 

र्बू  :  ['र', '्', 'ब', 'ू'] 

र्बे  :  ['र', '्', 'ब', 'े'] 

र्बै  :  ['र', '्', 'ब', 'ै'] 

र्बो  :  ['र', '्', 'ब', 'ो'] 

र्बौ  :  ['र', '्', 'ब', 'ौ'] 

र्बं  :  ['र', '्', 'ब', 'ं'] 

र्बः  :  ['र', '्', 'ब', 'ः'] 

भ्  :  ['भ', '्'] 

भ  :  ['भ'] 

भा  :  ['भ', 'ा'] 

भि  :  ['भ', 'ि'] 

भी  :  ['भ', 'ी'] 

भु  :  ['भ', 'ु'] 

भू  :  ['भ', 'ू'] 

भे  :  ['भ', 'े'] 

भै  :  ['भ', 'ै'] 

भो  :  ['भ', 'ो'] 

भौ  :  ['भ', 'ौ'] 

भं  :  ['भ', 'ं'] 

भः  :  ['भ', 'ः'] 

भृ्  :  ['भ', 'ृ', '्'] 

भृ  :  ['भ', 'ृ'] 

भृा  :  ['भ', 'ृ', 'ा'] 

भृि  :  ['भ', 'ृ', 'ि'] 

भृी  :  ['भ', 'ृ', 'ी'] 

भृु  :  ['भ', 'ृ', 'ु'] 

भृू  :  ['भ', 'ृ', 'ू'] 

भृे  :  ['भ', 'ृ', 'े'] 

भृै  :  ['भ', 'ृ', 'ै'] 

भृो  :  ['भ', 'ृ', 'ो'] 

भृौ  :  ['भ', 'ृ', 'ौ'] 

भृं  :  ['भ', 'ृ', 'ं'] 

भृः  :  ['भ', 'ृ', 'ः'] 

भ्र्  :  ['भ', '्', 'र', '्'] 

भ्र  :  ['भ', '्', 'र'] 

भ्रा  :  ['भ', '्', 'र', 'ा'] 

भ्रि  :  ['भ', '्', 'र', 'ि'] 

भ्री  :  ['भ', '्', 'र', 'ी'] 

भ्रु  :  ['भ', '्', 'र', 'ु'] 

भ्रू  :  ['भ', '्', 'र', 'ू'] 

भ्रे  :  ['भ', '्', 'र', 'े'] 

भ्रै  :  ['भ', '्', 'र', 'ै'] 

भ्रो  :  ['भ', '्', 'र', 'ो'] 

भ्रौ  :  ['भ', '्', 'र', 'ौ'] 

भ्रं  :  ['भ', '्', 'र', 'ं'] 

भ्रः  :  ['भ', '्', 'र', 'ः'] 

र्भ्  :  ['र', '्', 'भ', '्'] 

र्भ  :  ['र', '्', 'भ'] 

र्भा  :  ['र', '्', 'भ', 'ा'] 

र्भि  :  ['र', '्', 'भ', 'ि'] 

र्भी  :  ['र', '्', 'भ', 'ी'] 

र्भु  :  ['र', '्', 'भ', 'ु'] 

र्भू  :  ['र', '्', 'भ', 'ू'] 

र्भे  :  ['र', '्', 'भ', 'े'] 

र्भै  :  ['र', '्', 'भ', 'ै'] 

र्भो  :  ['र', '्', 'भ', 'ो'] 

र्भौ  :  ['र', '्', 'भ', 'ौ'] 

र्भं  :  ['र', '्', 'भ', 'ं'] 

र्भः  :  ['र', '्', 'भ', 'ः'] 

म्  :  ['म', '्'] 

म  :  ['म'] 

मा  :  ['म', 'ा'] 

मि  :  ['म', 'ि'] 

मी  :  ['म', 'ी'] 

मु  :  ['म', 'ु'] 

मू  :  ['म', 'ू'] 

मे  :  ['म', 'े'] 

मै  :  ['म', 'ै'] 

मो  :  ['म', 'ो'] 

मौ  :  ['म', 'ौ'] 

मं  :  ['म', 'ं'] 

मः  :  ['म', 'ः'] 

मृ्  :  ['म', 'ृ', '्'] 

मृ  :  ['म', 'ृ'] 

मृा  :  ['म', 'ृ', 'ा'] 

मृि  :  ['म', 'ृ', 'ि'] 

मृी  :  ['म', 'ृ', 'ी'] 

मृु  :  ['म', 'ृ', 'ु'] 

मृू  :  ['म', 'ृ', 'ू'] 

मृे  :  ['म', 'ृ', 'े'] 

मृै  :  ['म', 'ृ', 'ै'] 

मृो  :  ['म', 'ृ', 'ो'] 

मृौ  :  ['म', 'ृ', 'ौ'] 

मृं  :  ['म', 'ृ', 'ं'] 

मृः  :  ['म', 'ृ', 'ः'] 

म्र्  :  ['म', '्', 'र', '्'] 

म्र  :  ['म', '्', 'र'] 

म्रा  :  ['म', '्', 'र', 'ा'] 

म्रि  :  ['म', '्', 'र', 'ि'] 

म्री  :  ['म', '्', 'र', 'ी'] 

म्रु  :  ['म', '्', 'र', 'ु'] 

म्रू  :  ['म', '्', 'र', 'ू'] 

म्रे  :  ['म', '्', 'र', 'े'] 

म्रै  :  ['म', '्', 'र', 'ै'] 

म्रो  :  ['म', '्', 'र', 'ो'] 

म्रौ  :  ['म', '्', 'र', 'ौ'] 

म्रं  :  ['म', '्', 'र', 'ं'] 

म्रः  :  ['म', '्', 'र', 'ः'] 

र्म्  :  ['र', '्', 'म', '्'] 

र्म  :  ['र', '्', 'म'] 

र्मा  :  ['र', '्', 'म', 'ा'] 

र्मि  :  ['र', '्', 'म', 'ि'] 

र्मी  :  ['र', '्', 'म', 'ी'] 

र्मु  :  ['र', '्', 'म', 'ु'] 

र्मू  :  ['र', '्', 'म', 'ू'] 

र्मे  :  ['र', '्', 'म', 'े'] 

र्मै  :  ['र', '्', 'म', 'ै'] 

र्मो  :  ['र', '्', 'म', 'ो'] 

र्मौ  :  ['र', '्', 'म', 'ौ'] 

र्मं  :  ['र', '्', 'म', 'ं'] 

र्मः  :  ['र', '्', 'म', 'ः'] 

य्  :  ['य', '्'] 

य  :  ['य'] 

या  :  ['य', 'ा'] 

यि  :  ['य', 'ि'] 

यी  :  ['य', 'ी'] 

यु  :  ['य', 'ु'] 

यू  :  ['य', 'ू'] 

ये  :  ['य', 'े'] 

यै  :  ['य', 'ै'] 

यो  :  ['य', 'ो'] 

यौ  :  ['य', 'ौ'] 

यं  :  ['य', 'ं'] 

यः  :  ['य', 'ः'] 

यृ्  :  ['य', 'ृ', '्'] 

यृ  :  ['य', 'ृ'] 

यृा  :  ['य', 'ृ', 'ा'] 

यृि  :  ['य', 'ृ', 'ि'] 

यृी  :  ['य', 'ृ', 'ी'] 

यृु  :  ['य', 'ृ', 'ु'] 

यृू  :  ['य', 'ृ', 'ू'] 

यृे  :  ['य', 'ृ', 'े'] 

यृै  :  ['य', 'ृ', 'ै'] 

यृो  :  ['य', 'ृ', 'ो'] 

यृौ  :  ['य', 'ृ', 'ौ'] 

यृं  :  ['य', 'ृ', 'ं'] 

यृः  :  ['य', 'ृ', 'ः'] 

य्र्  :  ['य', '्', 'र', '्'] 

य्र  :  ['य', '्', 'र'] 

य्रा  :  ['य', '्', 'र', 'ा'] 

य्रि  :  ['य', '्', 'र', 'ि'] 

य्री  :  ['य', '्', 'र', 'ी'] 

य्रु  :  ['य', '्', 'र', 'ु'] 

य्रू  :  ['य', '्', 'र', 'ू'] 

य्रे  :  ['य', '्', 'र', 'े'] 

य्रै  :  ['य', '्', 'र', 'ै'] 

य्रो  :  ['य', '्', 'र', 'ो'] 

य्रौ  :  ['य', '्', 'र', 'ौ'] 

य्रं  :  ['य', '्', 'र', 'ं'] 

य्रः  :  ['य', '्', 'र', 'ः'] 

र्य्  :  ['र', '्', 'य', '्'] 

र्य  :  ['र', '्', 'य'] 

र्या  :  ['र', '्', 'य', 'ा'] 

र्यि  :  ['र', '्', 'य', 'ि'] 

र्यी  :  ['र', '्', 'य', 'ी'] 

र्यु  :  ['र', '्', 'य', 'ु'] 

र्यू  :  ['र', '्', 'य', 'ू'] 

र्ये  :  ['र', '्', 'य', 'े'] 

र्यै  :  ['र', '्', 'य', 'ै'] 

र्यो  :  ['र', '्', 'य', 'ो'] 

र्यौ  :  ['र', '्', 'य', 'ौ'] 

र्यं  :  ['र', '्', 'य', 'ं'] 

र्यः  :  ['र', '्', 'य', 'ः'] 

र्  :  ['र', '्'] 

र  :  ['र'] 

रा  :  ['र', 'ा'] 

रि  :  ['र', 'ि'] 

री  :  ['र', 'ी'] 

रु  :  ['र', 'ु'] 

रू  :  ['र', 'ू'] 

रे  :  ['र', 'े'] 

रै  :  ['र', 'ै'] 

रो  :  ['र', 'ो'] 

रौ  :  ['र', 'ौ'] 

रं  :  ['र', 'ं'] 

रः  :  ['र', 'ः'] 

रृ्  :  ['र', 'ृ', '्'] 

रृ  :  ['र', 'ृ'] 

रृा  :  ['र', 'ृ', 'ा'] 

रृि  :  ['र', 'ृ', 'ि'] 

रृी  :  ['र', 'ृ', 'ी'] 

रृु  :  ['र', 'ृ', 'ु'] 

रृू  :  ['र', 'ृ', 'ू'] 

रृे  :  ['र', 'ृ', 'े'] 

रृै  :  ['र', 'ृ', 'ै'] 

रृो  :  ['र', 'ृ', 'ो'] 

रृौ  :  ['र', 'ृ', 'ौ'] 

रृं  :  ['र', 'ृ', 'ं'] 

रृः  :  ['र', 'ृ', 'ः'] 

र्र्  :  ['र', '्', 'र', '्'] 

र्र  :  ['र', '्', 'र'] 

र्रा  :  ['र', '्', 'र', 'ा'] 

र्रि  :  ['र', '्', 'र', 'ि'] 

र्री  :  ['र', '्', 'र', 'ी'] 

र्रु  :  ['र', '्', 'र', 'ु'] 

र्रू  :  ['र', '्', 'र', 'ू'] 

र्रे  :  ['र', '्', 'र', 'े'] 

र्रै  :  ['र', '्', 'र', 'ै'] 

र्रो  :  ['र', '्', 'र', 'ो'] 

र्रौ  :  ['र', '्', 'र', 'ौ'] 

र्रं  :  ['र', '्', 'र', 'ं'] 

र्रः  :  ['र', '्', 'र', 'ः'] 

र्र्  :  ['र', '्', 'र', '्'] 

र्र  :  ['र', '्', 'र'] 

र्रा  :  ['र', '्', 'र', 'ा'] 

र्रि  :  ['र', '्', 'र', 'ि'] 

र्री  :  ['र', '्', 'र', 'ी'] 

र्रु  :  ['र', '्', 'र', 'ु'] 

र्रू  :  ['र', '्', 'र', 'ू'] 

र्रे  :  ['र', '्', 'र', 'े'] 

र्रै  :  ['र', '्', 'र', 'ै'] 

र्रो  :  ['र', '्', 'र', 'ो'] 

र्रौ  :  ['र', '्', 'र', 'ौ'] 

र्रं  :  ['र', '्', 'र', 'ं'] 

र्रः  :  ['र', '्', 'र', 'ः'] 

ल्  :  ['ल', '्'] 

ल  :  ['ल'] 

ला  :  ['ल', 'ा'] 

लि  :  ['ल', 'ि'] 

ली  :  ['ल', 'ी'] 

लु  :  ['ल', 'ु'] 

लू  :  ['ल', 'ू'] 

ले  :  ['ल', 'े'] 

लै  :  ['ल', 'ै'] 

लो  :  ['ल', 'ो'] 

लौ  :  ['ल', 'ौ'] 

लं  :  ['ल', 'ं'] 

लः  :  ['ल', 'ः'] 

लृ्  :  ['ल', 'ृ', '्'] 

लृ  :  ['ल', 'ृ'] 

लृा  :  ['ल', 'ृ', 'ा'] 

लृि  :  ['ल', 'ृ', 'ि'] 

लृी  :  ['ल', 'ृ', 'ी'] 

लृु  :  ['ल', 'ृ', 'ु'] 

लृू  :  ['ल', 'ृ', 'ू'] 

लृे  :  ['ल', 'ृ', 'े'] 

लृै  :  ['ल', 'ृ', 'ै'] 

लृो  :  ['ल', 'ृ', 'ो'] 

लृौ  :  ['ल', 'ृ', 'ौ'] 

लृं  :  ['ल', 'ृ', 'ं'] 

लृः  :  ['ल', 'ृ', 'ः'] 

ल्र्  :  ['ल', '्', 'र', '्'] 

ल्र  :  ['ल', '्', 'र'] 

ल्रा  :  ['ल', '्', 'र', 'ा'] 

ल्रि  :  ['ल', '्', 'र', 'ि'] 

ल्री  :  ['ल', '्', 'र', 'ी'] 

ल्रु  :  ['ल', '्', 'र', 'ु'] 

ल्रू  :  ['ल', '्', 'र', 'ू'] 

ल्रे  :  ['ल', '्', 'र', 'े'] 

ल्रै  :  ['ल', '्', 'र', 'ै'] 

ल्रो  :  ['ल', '्', 'र', 'ो'] 

ल्रौ  :  ['ल', '्', 'र', 'ौ'] 

ल्रं  :  ['ल', '्', 'र', 'ं'] 

ल्रः  :  ['ल', '्', 'र', 'ः'] 

र्ल्  :  ['र', '्', 'ल', '्'] 

र्ल  :  ['र', '्', 'ल'] 

र्ला  :  ['र', '्', 'ल', 'ा'] 

र्लि  :  ['र', '्', 'ल', 'ि'] 

र्ली  :  ['र', '्', 'ल', 'ी'] 

र्लु  :  ['र', '्', 'ल', 'ु'] 

र्लू  :  ['र', '्', 'ल', 'ू'] 

र्ले  :  ['र', '्', 'ल', 'े'] 

र्लै  :  ['र', '्', 'ल', 'ै'] 

र्लो  :  ['र', '्', 'ल', 'ो'] 

र्लौ  :  ['र', '्', 'ल', 'ौ'] 

र्लं  :  ['र', '्', 'ल', 'ं'] 

र्लः  :  ['र', '्', 'ल', 'ः'] 

ळ्  :  ['ळ', '्'] 

ळ  :  ['ळ'] 

ळा  :  ['ळ', 'ा'] 

ळि  :  ['ळ', 'ि'] 

ळी  :  ['ळ', 'ी'] 

ळु  :  ['ळ', 'ु'] 

ळू  :  ['ळ', 'ू'] 

ळे  :  ['ळ', 'े'] 

ळै  :  ['ळ', 'ै'] 

ळो  :  ['ळ', 'ो'] 

ळौ  :  ['ळ', 'ौ'] 

ळं  :  ['ळ', 'ं'] 

ळः  :  ['ळ', 'ः'] 

ळृ्  :  ['ळ', 'ृ', '्'] 

ळृ  :  ['ळ', 'ृ'] 

ळृा  :  ['ळ', 'ृ', 'ा'] 

ळृि  :  ['ळ', 'ृ', 'ि'] 

ळृी  :  ['ळ', 'ृ', 'ी'] 

ळृु  :  ['ळ', 'ृ', 'ु'] 

ळृू  :  ['ळ', 'ृ', 'ू'] 

ळृे  :  ['ळ', 'ृ', 'े'] 

ळृै  :  ['ळ', 'ृ', 'ै'] 

ळृो  :  ['ळ', 'ृ', 'ो'] 

ळृौ  :  ['ळ', 'ृ', 'ौ'] 

ळृं  :  ['ळ', 'ृ', 'ं'] 

ळृः  :  ['ळ', 'ृ', 'ः'] 

ळ्र्  :  ['ळ', '्', 'र', '्'] 

ळ्र  :  ['ळ', '्', 'र'] 

ळ्रा  :  ['ळ', '्', 'र', 'ा'] 

ळ्रि  :  ['ळ', '्', 'र', 'ि'] 

ळ्री  :  ['ळ', '्', 'र', 'ी'] 

ळ्रु  :  ['ळ', '्', 'र', 'ु'] 

ळ्रू  :  ['ळ', '्', 'र', 'ू'] 

ळ्रे  :  ['ळ', '्', 'र', 'े'] 

ळ्रै  :  ['ळ', '्', 'र', 'ै'] 

ळ्रो  :  ['ळ', '्', 'र', 'ो'] 

ळ्रौ  :  ['ळ', '्', 'र', 'ौ'] 

ळ्रं  :  ['ळ', '्', 'र', 'ं'] 

ळ्रः  :  ['ळ', '्', 'र', 'ः'] 

र्ळ्  :  ['र', '्', 'ळ', '्'] 

र्ळ  :  ['र', '्', 'ळ'] 

र्ळा  :  ['र', '्', 'ळ', 'ा'] 

र्ळि  :  ['र', '्', 'ळ', 'ि'] 

र्ळी  :  ['र', '्', 'ळ', 'ी'] 

र्ळु  :  ['र', '्', 'ळ', 'ु'] 

र्ळू  :  ['र', '्', 'ळ', 'ू'] 

र्ळे  :  ['र', '्', 'ळ', 'े'] 

र्ळै  :  ['र', '्', 'ळ', 'ै'] 

र्ळो  :  ['र', '्', 'ळ', 'ो'] 

र्ळौ  :  ['र', '्', 'ळ', 'ौ'] 

र्ळं  :  ['र', '्', 'ळ', 'ं'] 

र्ळः  :  ['र', '्', 'ळ', 'ः'] 

व्  :  ['व', '्'] 

व  :  ['व'] 

वा  :  ['व', 'ा'] 

वि  :  ['व', 'ि'] 

वी  :  ['व', 'ी'] 

वु  :  ['व', 'ु'] 

वू  :  ['व', 'ू'] 

वे  :  ['व', 'े'] 

वै  :  ['व', 'ै'] 

वो  :  ['व', 'ो'] 

वौ  :  ['व', 'ौ'] 

वं  :  ['व', 'ं'] 

वः  :  ['व', 'ः'] 

वृ्  :  ['व', 'ृ', '्'] 

वृ  :  ['व', 'ृ'] 

वृा  :  ['व', 'ृ', 'ा'] 

वृि  :  ['व', 'ृ', 'ि'] 

वृी  :  ['व', 'ृ', 'ी'] 

वृु  :  ['व', 'ृ', 'ु'] 

वृू  :  ['व', 'ृ', 'ू'] 

वृे  :  ['व', 'ृ', 'े'] 

वृै  :  ['व', 'ृ', 'ै'] 

वृो  :  ['व', 'ृ', 'ो'] 

वृौ  :  ['व', 'ृ', 'ौ'] 

वृं  :  ['व', 'ृ', 'ं'] 

वृः  :  ['व', 'ृ', 'ः'] 

व्र्  :  ['व', '्', 'र', '्'] 

व्र  :  ['व', '्', 'र'] 

व्रा  :  ['व', '्', 'र', 'ा'] 

व्रि  :  ['व', '्', 'र', 'ि'] 

व्री  :  ['व', '्', 'र', 'ी'] 

व्रु  :  ['व', '्', 'र', 'ु'] 

व्रू  :  ['व', '्', 'र', 'ू'] 

व्रे  :  ['व', '्', 'र', 'े'] 

व्रै  :  ['व', '्', 'र', 'ै'] 

व्रो  :  ['व', '्', 'र', 'ो'] 

व्रौ  :  ['व', '्', 'र', 'ौ'] 

व्रं  :  ['व', '्', 'र', 'ं'] 

व्रः  :  ['व', '्', 'र', 'ः'] 

र्व्  :  ['र', '्', 'व', '्'] 

र्व  :  ['र', '्', 'व'] 

र्वा  :  ['र', '्', 'व', 'ा'] 

र्वि  :  ['र', '्', 'व', 'ि'] 

र्वी  :  ['र', '्', 'व', 'ी'] 

र्वु  :  ['र', '्', 'व', 'ु'] 

र्वू  :  ['र', '्', 'व', 'ू'] 

र्वे  :  ['र', '्', 'व', 'े'] 

र्वै  :  ['र', '्', 'व', 'ै'] 

र्वो  :  ['र', '्', 'व', 'ो'] 

र्वौ  :  ['र', '्', 'व', 'ौ'] 

र्वं  :  ['र', '्', 'व', 'ं'] 

र्वः  :  ['र', '्', 'व', 'ः'] 

श्  :  ['श', '्'] 

श  :  ['श'] 

शा  :  ['श', 'ा'] 

शि  :  ['श', 'ि'] 

शी  :  ['श', 'ी'] 

शु  :  ['श', 'ु'] 

शू  :  ['श', 'ू'] 

शे  :  ['श', 'े'] 

शै  :  ['श', 'ै'] 

शो  :  ['श', 'ो'] 

शौ  :  ['श', 'ौ'] 

शं  :  ['श', 'ं'] 

शः  :  ['श', 'ः'] 

शृ्  :  ['श', 'ृ', '्'] 

शृ  :  ['श', 'ृ'] 

शृा  :  ['श', 'ृ', 'ा'] 

शृि  :  ['श', 'ृ', 'ि'] 

शृी  :  ['श', 'ृ', 'ी'] 

शृु  :  ['श', 'ृ', 'ु'] 

शृू  :  ['श', 'ृ', 'ू'] 

शृे  :  ['श', 'ृ', 'े'] 

शृै  :  ['श', 'ृ', 'ै'] 

शृो  :  ['श', 'ृ', 'ो'] 

शृौ  :  ['श', 'ृ', 'ौ'] 

शृं  :  ['श', 'ृ', 'ं'] 

शृः  :  ['श', 'ृ', 'ः'] 

श्र्  :  ['श', '्', 'र', '्'] 

श्र  :  ['श', '्', 'र'] 

श्रा  :  ['श', '्', 'र', 'ा'] 

श्रि  :  ['श', '्', 'र', 'ि'] 

श्री  :  ['श', '्', 'र', 'ी'] 

श्रु  :  ['श', '्', 'र', 'ु'] 

श्रू  :  ['श', '्', 'र', 'ू'] 

श्रे  :  ['श', '्', 'र', 'े'] 

श्रै  :  ['श', '्', 'र', 'ै'] 

श्रो  :  ['श', '्', 'र', 'ो'] 

श्रौ  :  ['श', '्', 'र', 'ौ'] 

श्रं  :  ['श', '्', 'र', 'ं'] 

श्रः  :  ['श', '्', 'र', 'ः'] 

र्श्  :  ['र', '्', 'श', '्'] 

र्श  :  ['र', '्', 'श'] 

र्शा  :  ['र', '्', 'श', 'ा'] 

र्शि  :  ['र', '्', 'श', 'ि'] 

र्शी  :  ['र', '्', 'श', 'ी'] 

र्शु  :  ['र', '्', 'श', 'ु'] 

र्शू  :  ['र', '्', 'श', 'ू'] 

र्शे  :  ['र', '्', 'श', 'े'] 

र्शै  :  ['र', '्', 'श', 'ै'] 

र्शो  :  ['र', '्', 'श', 'ो'] 

र्शौ  :  ['र', '्', 'श', 'ौ'] 

र्शं  :  ['र', '्', 'श', 'ं'] 

र्शः  :  ['र', '्', 'श', 'ः'] 

ष्  :  ['ष', '्'] 

ष  :  ['ष'] 

षा  :  ['ष', 'ा'] 

षि  :  ['ष', 'ि'] 

षी  :  ['ष', 'ी'] 

षु  :  ['ष', 'ु'] 

षू  :  ['ष', 'ू'] 

षे  :  ['ष', 'े'] 

षै  :  ['ष', 'ै'] 

षो  :  ['ष', 'ो'] 

षौ  :  ['ष', 'ौ'] 

षं  :  ['ष', 'ं'] 

षः  :  ['ष', 'ः'] 

षृ्  :  ['ष', 'ृ', '्'] 

षृ  :  ['ष', 'ृ'] 

षृा  :  ['ष', 'ृ', 'ा'] 

षृि  :  ['ष', 'ृ', 'ि'] 

षृी  :  ['ष', 'ृ', 'ी'] 

षृु  :  ['ष', 'ृ', 'ु'] 

षृू  :  ['ष', 'ृ', 'ू'] 

षृे  :  ['ष', 'ृ', 'े'] 

षृै  :  ['ष', 'ृ', 'ै'] 

षृो  :  ['ष', 'ृ', 'ो'] 

षृौ  :  ['ष', 'ृ', 'ौ'] 

षृं  :  ['ष', 'ृ', 'ं'] 

षृः  :  ['ष', 'ृ', 'ः'] 

ष्र्  :  ['ष', '्', 'र', '्'] 

ष्र  :  ['ष', '्', 'र'] 

ष्रा  :  ['ष', '्', 'र', 'ा'] 

ष्रि  :  ['ष', '्', 'र', 'ि'] 

ष्री  :  ['ष', '्', 'र', 'ी'] 

ष्रु  :  ['ष', '्', 'र', 'ु'] 

ष्रू  :  ['ष', '्', 'र', 'ू'] 

ष्रे  :  ['ष', '्', 'र', 'े'] 

ष्रै  :  ['ष', '्', 'र', 'ै'] 

ष्रो  :  ['ष', '्', 'र', 'ो'] 

ष्रौ  :  ['ष', '्', 'र', 'ौ'] 

ष्रं  :  ['ष', '्', 'र', 'ं'] 

ष्रः  :  ['ष', '्', 'र', 'ः'] 

र्ष्  :  ['र', '्', 'ष', '्'] 

र्ष  :  ['र', '्', 'ष'] 

र्षा  :  ['र', '्', 'ष', 'ा'] 

र्षि  :  ['र', '्', 'ष', 'ि'] 

र्षी  :  ['र', '्', 'ष', 'ी'] 

र्षु  :  ['र', '्', 'ष', 'ु'] 

र्षू  :  ['र', '्', 'ष', 'ू'] 

र्षे  :  ['र', '्', 'ष', 'े'] 

र्षै  :  ['र', '्', 'ष', 'ै'] 

र्षो  :  ['र', '्', 'ष', 'ो'] 

र्षौ  :  ['र', '्', 'ष', 'ौ'] 

र्षं  :  ['र', '्', 'ष', 'ं'] 

र्षः  :  ['र', '्', 'ष', 'ः'] 

स्  :  ['स', '्'] 

स  :  ['स'] 

सा  :  ['स', 'ा'] 

सि  :  ['स', 'ि'] 

सी  :  ['स', 'ी'] 

सु  :  ['स', 'ु'] 

सू  :  ['स', 'ू'] 

से  :  ['स', 'े'] 

सै  :  ['स', 'ै'] 

सो  :  ['स', 'ो'] 

सौ  :  ['स', 'ौ'] 

सं  :  ['स', 'ं'] 

सः  :  ['स', 'ः'] 

सृ्  :  ['स', 'ृ', '्'] 

सृ  :  ['स', 'ृ'] 

सृा  :  ['स', 'ृ', 'ा'] 

सृि  :  ['स', 'ृ', 'ि'] 

सृी  :  ['स', 'ृ', 'ी'] 

सृु  :  ['स', 'ृ', 'ु'] 

सृू  :  ['स', 'ृ', 'ू'] 

सृे  :  ['स', 'ृ', 'े'] 

सृै  :  ['स', 'ृ', 'ै'] 

सृो  :  ['स', 'ृ', 'ो'] 

सृौ  :  ['स', 'ृ', 'ौ'] 

सृं  :  ['स', 'ृ', 'ं'] 

सृः  :  ['स', 'ृ', 'ः'] 

स्र्  :  ['स', '्', 'र', '्'] 

स्र  :  ['स', '्', 'र'] 

स्रा  :  ['स', '्', 'र', 'ा'] 

स्रि  :  ['स', '्', 'र', 'ि'] 

स्री  :  ['स', '्', 'र', 'ी'] 

स्रु  :  ['स', '्', 'र', 'ु'] 

स्रू  :  ['स', '्', 'र', 'ू'] 

स्रे  :  ['स', '्', 'र', 'े'] 

स्रै  :  ['स', '्', 'र', 'ै'] 

स्रो  :  ['स', '्', 'र', 'ो'] 

स्रौ  :  ['स', '्', 'र', 'ौ'] 

स्रं  :  ['स', '्', 'र', 'ं'] 

स्रः  :  ['स', '्', 'र', 'ः'] 

र्स्  :  ['र', '्', 'स', '्'] 

र्स  :  ['र', '्', 'स'] 

र्सा  :  ['र', '्', 'स', 'ा'] 

र्सि  :  ['र', '्', 'स', 'ि'] 

र्सी  :  ['र', '्', 'स', 'ी'] 

र्सु  :  ['र', '्', 'स', 'ु'] 

र्सू  :  ['र', '्', 'स', 'ू'] 

र्से  :  ['र', '्', 'स', 'े'] 

र्सै  :  ['र', '्', 'स', 'ै'] 

र्सो  :  ['र', '्', 'स', 'ो'] 

र्सौ  :  ['र', '्', 'स', 'ौ'] 

र्सं  :  ['र', '्', 'स', 'ं'] 

र्सः  :  ['र', '्', 'स', 'ः'] 

ह्  :  ['ह', '्'] 

ह  :  ['ह'] 

हा  :  ['ह', 'ा'] 

हि  :  ['ह', 'ि'] 

ही  :  ['ह', 'ी'] 

हु  :  ['ह', 'ु'] 

हू  :  ['ह', 'ू'] 

हे  :  ['ह', 'े'] 

है  :  ['ह', 'ै'] 

हो  :  ['ह', 'ो'] 

हौ  :  ['ह', 'ौ'] 

हं  :  ['ह', 'ं'] 

हः  :  ['ह', 'ः'] 

हृ्  :  ['ह', 'ृ', '्'] 

हृ  :  ['ह', 'ृ'] 

हृा  :  ['ह', 'ृ', 'ा'] 

हृि  :  ['ह', 'ृ', 'ि'] 

हृी  :  ['ह', 'ृ', 'ी'] 

हृु  :  ['ह', 'ृ', 'ु'] 

हृू  :  ['ह', 'ृ', 'ू'] 

हृे  :  ['ह', 'ृ', 'े'] 

हृै  :  ['ह', 'ृ', 'ै'] 

हृो  :  ['ह', 'ृ', 'ो'] 

हृौ  :  ['ह', 'ृ', 'ौ'] 

हृं  :  ['ह', 'ृ', 'ं'] 

हृः  :  ['ह', 'ृ', 'ः'] 

ह्र्  :  ['ह', '्', 'र', '्'] 

ह्र  :  ['ह', '्', 'र'] 

ह्रा  :  ['ह', '्', 'र', 'ा'] 

ह्रि  :  ['ह', '्', 'र', 'ि'] 

ह्री  :  ['ह', '्', 'र', 'ी'] 

ह्रु  :  ['ह', '्', 'र', 'ु'] 

ह्रू  :  ['ह', '्', 'र', 'ू'] 

ह्रे  :  ['ह', '्', 'र', 'े'] 

ह्रै  :  ['ह', '्', 'र', 'ै'] 

ह्रो  :  ['ह', '्', 'र', 'ो'] 

ह्रौ  :  ['ह', '्', 'र', 'ौ'] 

ह्रं  :  ['ह', '्', 'र', 'ं'] 

ह्रः  :  ['ह', '्', 'र', 'ः'] 

र्ह्  :  ['र', '्', 'ह', '्'] 

र्ह  :  ['र', '्', 'ह'] 

र्हा  :  ['र', '्', 'ह', 'ा'] 

र्हि  :  ['र', '्', 'ह', 'ि'] 

र्ही  :  ['र', '्', 'ह', 'ी'] 

र्हु  :  ['र', '्', 'ह', 'ु'] 

र्हू  :  ['र', '्', 'ह', 'ू'] 

र्हे  :  ['र', '्', 'ह', 'े'] 

र्है  :  ['र', '्', 'ह', 'ै'] 

र्हो  :  ['र', '्', 'ह', 'ो'] 

र्हौ  :  ['र', '्', 'ह', 'ौ'] 

र्हं  :  ['र', '्', 'ह', 'ं'] 

र्हः  :  ['र', '्', 'ह', 'ः'] 

क्ष्  :  ['क', '्', 'ष', '्'] 

क्ष  :  ['क', '्', 'ष'] 

क्षा  :  ['क', '्', 'ष', 'ा'] 

क्षि  :  ['क', '्', 'ष', 'ि'] 

क्षी  :  ['क', '्', 'ष', 'ी'] 

क्षु  :  ['क', '्', 'ष', 'ु'] 

क्षू  :  ['क', '्', 'ष', 'ू'] 

क्षे  :  ['क', '्', 'ष', 'े'] 

क्षै  :  ['क', '्', 'ष', 'ै'] 

क्षो  :  ['क', '्', 'ष', 'ो'] 

क्षौ  :  ['क', '्', 'ष', 'ौ'] 

क्षं  :  ['क', '्', 'ष', 'ं'] 

क्षः  :  ['क', '्', 'ष', 'ः'] 

त्र्  :  ['त', '्', 'र', '्'] 

त्र  :  ['त', '्', 'र'] 

त्रा  :  ['त', '्', 'र', 'ा'] 

त्रि  :  ['त', '्', 'र', 'ि'] 

त्री  :  ['त', '्', 'र', 'ी'] 

त्रु  :  ['त', '्', 'र', 'ु'] 

त्रू  :  ['त', '्', 'र', 'ू'] 

त्रे  :  ['त', '्', 'र', 'े'] 

त्रै  :  ['त', '्', 'र', 'ै'] 

त्रो  :  ['त', '्', 'र', 'ो'] 

त्रौ  :  ['त', '्', 'र', 'ौ'] 

त्रं  :  ['त', '्', 'र', 'ं'] 

त्रः  :  ['त', '्', 'र', 'ः'] 

त्रृ्  :  ['त', '्', 'र', 'ृ', '्'] 

त्रृ  :  ['त', '्', 'र', 'ृ'] 

त्रृा  :  ['त', '्', 'र', 'ृ', 'ा'] 

त्रृि  :  ['त', '्', 'र', 'ृ', 'ि'] 

त्रृी  :  ['त', '्', 'र', 'ृ', 'ी'] 

त्रृु  :  ['त', '्', 'र', 'ृ', 'ु'] 

त्रृू  :  ['त', '्', 'र', 'ृ', 'ू'] 

त्रृे  :  ['त', '्', 'र', 'ृ', 'े'] 

त्रृै  :  ['त', '्', 'र', 'ृ', 'ै'] 

त्रृो  :  ['त', '्', 'र', 'ृ', 'ो'] 

त्रृौ  :  ['त', '्', 'र', 'ृ', 'ौ'] 

त्रृं  :  ['त', '्', 'र', 'ृ', 'ं'] 

त्रृः  :  ['त', '्', 'र', 'ृ', 'ः'] 

त्र्र्  :  ['त', '्', 'र', '्', 'र', '्'] 

त्र्र  :  ['त', '्', 'र', '्', 'र'] 

त्र्रा  :  ['त', '्', 'र', '्', 'र', 'ा'] 

त्र्रि  :  ['त', '्', 'र', '्', 'र', 'ि'] 

त्र्री  :  ['त', '्', 'र', '्', 'र', 'ी'] 

त्र्रु  :  ['त', '्', 'र', '्', 'र', 'ु'] 

त्र्रू  :  ['त', '्', 'र', '्', 'र', 'ू'] 

त्र्रे  :  ['त', '्', 'र', '्', 'र', 'े'] 

त्र्रै  :  ['त', '्', 'र', '्', 'र', 'ै'] 

त्र्रो  :  ['त', '्', 'र', '्', 'र', 'ो'] 

त्र्रौ  :  ['त', '्', 'र', '्', 'र', 'ौ'] 

त्र्रं  :  ['त', '्', 'र', '्', 'र', 'ं'] 

त्र्रः  :  ['त', '्', 'र', '्', 'र', 'ः'] 

र्त्र्  :  ['र', '्', 'त', '्', 'र', '्'] 

र्त्र  :  ['र', '्', 'त', '्', 'र'] 

र्त्रा  :  ['र', '्', 'त', '्', 'र', 'ा'] 

र्त्रि  :  ['र', '्', 'त', '्', 'र', 'ि'] 

र्त्री  :  ['र', '्', 'त', '्', 'र', 'ी'] 

र्त्रु  :  ['र', '्', 'त', '्', 'र', 'ु'] 

र्त्रू  :  ['र', '्', 'त', '्', 'र', 'ू'] 

र्त्रे  :  ['र', '्', 'त', '्', 'र', 'े'] 

र्त्रै  :  ['र', '्', 'त', '्', 'र', 'ै'] 

र्त्रो  :  ['र', '्', 'त', '्', 'र', 'ो'] 

र्त्रौ  :  ['र', '्', 'त', '्', 'र', 'ौ'] 

र्त्रं  :  ['र', '्', 'त', '्', 'र', 'ं'] 

र्त्रः  :  ['र', '्', 'त', '्', 'र', 'ः'] 

ज्ञ्  :  ['ज', '्', 'ञ', '्'] 

ज्ञ  :  ['ज', '्', 'ञ'] 

ज्ञा  :  ['ज', '्', 'ञ', 'ा'] 

ज्ञि  :  ['ज', '्', 'ञ', 'ि'] 

ज्ञी  :  ['ज', '्', 'ञ', 'ी'] 

ज्ञु  :  ['ज', '्', 'ञ', 'ु'] 

ज्ञू  :  ['ज', '्', 'ञ', 'ू'] 

ज्ञे  :  ['ज', '्', 'ञ', 'े'] 

ज्ञै  :  ['ज', '्', 'ञ', 'ै'] 

ज्ञो  :  ['ज', '्', 'ञ', 'ो'] 

ज्ञौ  :  ['ज', '्', 'ञ', 'ौ'] 

ज्ञं  :  ['ज', '्', 'ञ', 'ं'] 

ज्ञः  :  ['ज', '्', 'ञ', 'ः'] 

ज्ञृ्  :  ['ज', '्', 'ञ', 'ृ', '्'] 

ज्ञृ  :  ['ज', '्', 'ञ', 'ृ'] 

ज्ञृा  :  ['ज', '्', 'ञ', 'ृ', 'ा'] 

ज्ञृि  :  ['ज', '्', 'ञ', 'ृ', 'ि'] 

ज्ञृी  :  ['ज', '्', 'ञ', 'ृ', 'ी'] 

ज्ञृु  :  ['ज', '्', 'ञ', 'ृ', 'ु'] 

ज्ञृू  :  ['ज', '्', 'ञ', 'ृ', 'ू'] 

ज्ञृे  :  ['ज', '्', 'ञ', 'ृ', 'े'] 

ज्ञृै  :  ['ज', '्', 'ञ', 'ृ', 'ै'] 

ज्ञृो  :  ['ज', '्', 'ञ', 'ृ', 'ो'] 

ज्ञृौ  :  ['ज', '्', 'ञ', 'ृ', 'ौ'] 

ज्ञृं  :  ['ज', '्', 'ञ', 'ृ', 'ं'] 

ज्ञृः  :  ['ज', '्', 'ञ', 'ृ', 'ः'] 

ज्ञ्र्  :  ['ज', '्', 'ञ', '्', 'र', '्'] 

ज्ञ्र  :  ['ज', '्', 'ञ', '्', 'र'] 

ज्ञ्रा  :  ['ज', '्', 'ञ', '्', 'र', 'ा'] 

ज्ञ्रि  :  ['ज', '्', 'ञ', '्', 'र', 'ि'] 

ज्ञ्री  :  ['ज', '्', 'ञ', '्', 'र', 'ी'] 

ज्ञ्रु  :  ['ज', '्', 'ञ', '्', 'र', 'ु'] 

ज्ञ्रू  :  ['ज', '्', 'ञ', '्', 'र', 'ू'] 

ज्ञ्रे  :  ['ज', '्', 'ञ', '्', 'र', 'े'] 

ज्ञ्रै  :  ['ज', '्', 'ञ', '्', 'र', 'ै'] 

ज्ञ्रो  :  ['ज', '्', 'ञ', '्', 'र', 'ो'] 

ज्ञ्रौ  :  ['ज', '्', 'ञ', '्', 'र', 'ौ'] 

ज्ञ्रं  :  ['ज', '्', 'ञ', '्', 'र', 'ं'] 

ज्ञ्रः  :  ['ज', '्', 'ञ', '्', 'र', 'ः'] 

र्ज्ञ्  :  ['र', '्', 'ज', '्', 'ञ', '्'] 

र्ज्ञ  :  ['र', '्', 'ज', '्', 'ञ'] 

र्ज्ञा  :  ['र', '्', 'ज', '्', 'ञ', 'ा'] 

र्ज्ञि  :  ['र', '्', 'ज', '्', 'ञ', 'ि'] 

र्ज्ञी  :  ['र', '्', 'ज', '्', 'ञ', 'ी'] 

र्ज्ञु  :  ['र', '्', 'ज', '्', 'ञ', 'ु'] 

र्ज्ञू  :  ['र', '्', 'ज', '्', 'ञ', 'ू'] 

र्ज्ञे  :  ['र', '्', 'ज', '्', 'ञ', 'े'] 

र्ज्ञै  :  ['र', '्', 'ज', '्', 'ञ', 'ै'] 

र्ज्ञो  :  ['र', '्', 'ज', '्', 'ञ', 'ो'] 

र्ज्ञौ  :  ['र', '्', 'ज', '्', 'ञ', 'ौ'] 

र्ज्ञं  :  ['र', '्', 'ज', '्', 'ञ', 'ं'] 

र्ज्ञः  :  ['र', '्', 'ज', '्', 'ञ', 'ः'] 

श्रृ्  :  ['श', '्', 'र', 'ृ', '्'] 

श्रृ  :  ['श', '्', 'र', 'ृ'] 

श्रृा  :  ['श', '्', 'र', 'ृ', 'ा'] 

श्रृि  :  ['श', '्', 'र', 'ृ', 'ि'] 

श्रृी  :  ['श', '्', 'र', 'ृ', 'ी'] 

श्रृु  :  ['श', '्', 'र', 'ृ', 'ु'] 

श्रृू  :  ['श', '्', 'र', 'ृ', 'ू'] 

श्रृे  :  ['श', '्', 'र', 'ृ', 'े'] 

श्रृै  :  ['श', '्', 'र', 'ृ', 'ै'] 

श्रृो  :  ['श', '्', 'र', 'ृ', 'ो'] 

श्रृौ  :  ['श', '्', 'र', 'ृ', 'ौ'] 

श्रृं  :  ['श', '्', 'र', 'ृ', 'ं'] 

श्रृः  :  ['श', '्', 'र', 'ृ', 'ः'] 

श्र्र्  :  ['श', '्', 'र', '्', 'र', '्'] 

श्र्र  :  ['श', '्', 'र', '्', 'र'] 

श्र्रा  :  ['श', '्', 'र', '्', 'र', 'ा'] 

श्र्रि  :  ['श', '्', 'र', '्', 'र', 'ि'] 

श्र्री  :  ['श', '्', 'र', '्', 'र', 'ी'] 

श्र्रु  :  ['श', '्', 'र', '्', 'र', 'ु'] 

श्र्रू  :  ['श', '्', 'र', '्', 'र', 'ू'] 

श्र्रे  :  ['श', '्', 'र', '्', 'र', 'े'] 

श्र्रै  :  ['श', '्', 'र', '्', 'र', 'ै'] 

श्र्रो  :  ['श', '्', 'र', '्', 'र', 'ो'] 

श्र्रौ  :  ['श', '्', 'र', '्', 'र', 'ौ'] 

श्र्रं  :  ['श', '्', 'र', '्', 'र', 'ं'] 

श्र्रः  :  ['श', '्', 'र', '्', 'र', 'ः'] 

र्श्र्  :  ['र', '्', 'श', '्', 'र', '्'] 

र्श्र  :  ['र', '्', 'श', '्', 'र'] 

र्श्रा  :  ['र', '्', 'श', '्', 'र', 'ा'] 

र्श्रि  :  ['र', '्', 'श', '्', 'र', 'ि'] 

र्श्री  :  ['र', '्', 'श', '्', 'र', 'ी'] 

र्श्रु  :  ['र', '्', 'श', '्', 'र', 'ु'] 

र्श्रू  :  ['र', '्', 'श', '्', 'र', 'ू'] 

र्श्रे  :  ['र', '्', 'श', '्', 'र', 'े'] 

र्श्रै  :  ['र', '्', 'श', '्', 'र', 'ै'] 

र्श्रो  :  ['र', '्', 'श', '्', 'र', 'ो'] 

र्श्रौ  :  ['र', '्', 'श', '्', 'र', 'ौ'] 

र्श्रं  :  ['र', '्', 'श', '्', 'र', 'ं'] 

र्श्रः  :  ['र', '्', 'श', '्', 'र', 'ः'] 

द्ध्  :  ['द', '्', 'ध', '्'] 

द्ध  :  ['द', '्', 'ध'] 

द्धा  :  ['द', '्', 'ध', 'ा'] 

द्धि  :  ['द', '्', 'ध', 'ि'] 

द्धी  :  ['द', '्', 'ध', 'ी'] 

द्धु  :  ['द', '्', 'ध', 'ु'] 

द्धू  :  ['द', '्', 'ध', 'ू'] 

द्धे  :  ['द', '्', 'ध', 'े'] 

द्धै  :  ['द', '्', 'ध', 'ै'] 

द्धो  :  ['द', '्', 'ध', 'ो'] 

द्धौ  :  ['द', '्', 'ध', 'ौ'] 

द्धं  :  ['द', '्', 'ध', 'ं'] 

द्धः  :  ['द', '्', 'ध', 'ः'] 

द्ध्र्  :  ['द', '्', 'ध', '्', 'र', '्'] 

द्ध्र  :  ['द', '्', 'ध', '्', 'र'] 

द्ध्रा  :  ['द', '्', 'ध', '्', 'र', 'ा'] 

द्ध्रि  :  ['द', '्', 'ध', '्', 'र', 'ि'] 

द्ध्री  :  ['द', '्', 'ध', '्', 'र', 'ी'] 

द्ध्रु  :  ['द', '्', 'ध', '्', 'र', 'ु'] 

द्ध्रू  :  ['द', '्', 'ध', '्', 'र', 'ू'] 

द्ध्रे  :  ['द', '्', 'ध', '्', 'र', 'े'] 

द्ध्रै  :  ['द', '्', 'ध', '्', 'र', 'ै'] 

द्ध्रो  :  ['द', '्', 'ध', '्', 'र', 'ो'] 

द्ध्रौ  :  ['द', '्', 'ध', '्', 'र', 'ौ'] 

द्ध्रं  :  ['द', '्', 'ध', '्', 'र', 'ं'] 

द्ध्रः  :  ['द', '्', 'ध', '्', 'र', 'ः'] 

र्द्ध्  :  ['र', '्', 'द', '्', 'ध', '्'] 

र्द्ध  :  ['र', '्', 'द', '्', 'ध'] 

र्द्धा  :  ['र', '्', 'द', '्', 'ध', 'ा'] 

र्द्धि  :  ['र', '्', 'द', '्', 'ध', 'ि'] 

र्द्धी  :  ['र', '्', 'द', '्', 'ध', 'ी'] 

र्द्धु  :  ['र', '्', 'द', '्', 'ध', 'ु'] 

र्द्धू  :  ['र', '्', 'द', '्', 'ध', 'ू'] 

र्द्धे  :  ['र', '्', 'द', '्', 'ध', 'े'] 

र्द्धै  :  ['र', '्', 'द', '्', 'ध', 'ै'] 

र्द्धो  :  ['र', '्', 'द', '्', 'ध', 'ो'] 

र्द्धौ  :  ['र', '्', 'द', '्', 'ध', 'ौ'] 

र्द्धं  :  ['र', '्', 'द', '्', 'ध', 'ं'] 

र्द्धः  :  ['र', '्', 'द', '्', 'ध', 'ः'] 

द्धृ्  :  ['द', '्', 'ध', 'ृ', '्'] 

द्धृ  :  ['द', '्', 'ध', 'ृ'] 

द्धृा  :  ['द', '्', 'ध', 'ृ', 'ा'] 

द्धृि  :  ['द', '्', 'ध', 'ृ', 'ि'] 

द्धृी  :  ['द', '्', 'ध', 'ृ', 'ी'] 

द्धृु  :  ['द', '्', 'ध', 'ृ', 'ु'] 

द्धृू  :  ['द', '्', 'ध', 'ृ', 'ू'] 

द्धृे  :  ['द', '्', 'ध', 'ृ', 'े'] 

द्धृै  :  ['द', '्', 'ध', 'ृ', 'ै'] 

द्धृो  :  ['द', '्', 'ध', 'ृ', 'ो'] 

द्धृौ  :  ['द', '्', 'ध', 'ृ', 'ौ'] 

द्धृं  :  ['द', '्', 'ध', 'ृ', 'ं'] 

द्धृः  :  ['द', '्', 'ध', 'ृ', 'ः'] 

द्य्  :  ['द', '्', 'य', '्'] 

द्य  :  ['द', '्', 'य'] 

द्या  :  ['द', '्', 'य', 'ा'] 

द्यि  :  ['द', '्', 'य', 'ि'] 

द्यी  :  ['द', '्', 'य', 'ी'] 

द्यु  :  ['द', '्', 'य', 'ु'] 

द्यू  :  ['द', '्', 'य', 'ू'] 

द्ये  :  ['द', '्', 'य', 'े'] 

द्यै  :  ['द', '्', 'य', 'ै'] 

द्यो  :  ['द', '्', 'य', 'ो'] 

द्यौ  :  ['द', '्', 'य', 'ौ'] 

द्यं  :  ['द', '्', 'य', 'ं'] 

द्यः  :  ['द', '्', 'य', 'ः'] 

द्य्र्  :  ['द', '्', 'य', '्', 'र', '्'] 

द्य्र  :  ['द', '्', 'य', '्', 'र'] 

द्य्रा  :  ['द', '्', 'य', '्', 'र', 'ा'] 

द्य्रि  :  ['द', '्', 'य', '्', 'र', 'ि'] 

द्य्री  :  ['द', '्', 'य', '्', 'र', 'ी'] 

द्य्रु  :  ['द', '्', 'य', '्', 'र', 'ु'] 

द्य्रू  :  ['द', '्', 'य', '्', 'र', 'ू'] 

द्य्रे  :  ['द', '्', 'य', '्', 'र', 'े'] 

द्य्रै  :  ['द', '्', 'य', '्', 'र', 'ै'] 

द्य्रो  :  ['द', '्', 'य', '्', 'र', 'ो'] 

द्य्रौ  :  ['द', '्', 'य', '्', 'र', 'ौ'] 

द्य्रं  :  ['द', '्', 'य', '्', 'र', 'ं'] 

द्य्रः  :  ['द', '्', 'य', '्', 'र', 'ः'] 

र्द्य्  :  ['र', '्', 'द', '्', 'य', '्'] 

र्द्य  :  ['र', '्', 'द', '्', 'य'] 

र्द्या  :  ['र', '्', 'द', '्', 'य', 'ा'] 

र्द्यि  :  ['र', '्', 'द', '्', 'य', 'ि'] 

र्द्यी  :  ['र', '्', 'द', '्', 'य', 'ी'] 

र्द्यु  :  ['र', '्', 'द', '्', 'य', 'ु'] 

र्द्यू  :  ['र', '्', 'द', '्', 'य', 'ू'] 

र्द्ये  :  ['र', '्', 'द', '्', 'य', 'े'] 

र्द्यै  :  ['र', '्', 'द', '्', 'य', 'ै'] 

र्द्यो  :  ['र', '्', 'द', '्', 'य', 'ो'] 

र्द्यौ  :  ['र', '्', 'द', '्', 'य', 'ौ'] 

र्द्यं  :  ['र', '्', 'द', '्', 'य', 'ं'] 

र्द्यः  :  ['र', '्', 'द', '्', 'य', 'ः'] 

द्यृ्  :  ['द', '्', 'य', 'ृ', '्'] 

द्यृ  :  ['द', '्', 'य', 'ृ'] 

द्यृा  :  ['द', '्', 'य', 'ृ', 'ा'] 

द्यृि  :  ['द', '्', 'य', 'ृ', 'ि'] 

द्यृी  :  ['द', '्', 'य', 'ृ', 'ी'] 

द्यृु  :  ['द', '्', 'य', 'ृ', 'ु'] 

द्यृू  :  ['द', '्', 'य', 'ृ', 'ू'] 

द्यृे  :  ['द', '्', 'य', 'ृ', 'े'] 

द्यृै  :  ['द', '्', 'य', 'ृ', 'ै'] 

द्यृो  :  ['द', '्', 'य', 'ृ', 'ो'] 

द्यृौ  :  ['द', '्', 'य', 'ृ', 'ौ'] 

द्यृं  :  ['द', '्', 'य', 'ृ', 'ं'] 

द्यृः  :  ['द', '्', 'य', 'ृ', 'ः'] 

द्व्  :  ['द', '्', 'व', '्'] 

द्व  :  ['द', '्', 'व'] 

द्वा  :  ['द', '्', 'व', 'ा'] 

द्वि  :  ['द', '्', 'व', 'ि'] 

द्वी  :  ['द', '्', 'व', 'ी'] 

द्वु  :  ['द', '्', 'व', 'ु'] 

द्वू  :  ['द', '्', 'व', 'ू'] 

द्वे  :  ['द', '्', 'व', 'े'] 

द्वै  :  ['द', '्', 'व', 'ै'] 

द्वो  :  ['द', '्', 'व', 'ो'] 

द्वौ  :  ['द', '्', 'व', 'ौ'] 

द्वं  :  ['द', '्', 'व', 'ं'] 

द्वः  :  ['द', '्', 'व', 'ः'] 

द्व्र्  :  ['द', '्', 'व', '्', 'र', '्'] 

द्व्र  :  ['द', '्', 'व', '्', 'र'] 

द्व्रा  :  ['द', '्', 'व', '्', 'र', 'ा'] 

द्व्रि  :  ['द', '्', 'व', '्', 'र', 'ि'] 

द्व्री  :  ['द', '्', 'व', '्', 'र', 'ी'] 

द्व्रु  :  ['द', '्', 'व', '्', 'र', 'ु'] 

द्व्रू  :  ['द', '्', 'व', '्', 'र', 'ू'] 

द्व्रे  :  ['द', '्', 'व', '्', 'र', 'े'] 

द्व्रै  :  ['द', '्', 'व', '्', 'र', 'ै'] 

द्व्रो  :  ['द', '्', 'व', '्', 'र', 'ो'] 

द्व्रौ  :  ['द', '्', 'व', '्', 'र', 'ौ'] 

द्व्रं  :  ['द', '्', 'व', '्', 'र', 'ं'] 

द्व्रः  :  ['द', '्', 'व', '्', 'र', 'ः'] 

र्द्व्  :  ['र', '्', 'द', '्', 'व', '्'] 

र्द्व  :  ['र', '्', 'द', '्', 'व'] 

र्द्वा  :  ['र', '्', 'द', '्', 'व', 'ा'] 

र्द्वि  :  ['र', '्', 'द', '्', 'व', 'ि'] 

र्द्वी  :  ['र', '्', 'द', '्', 'व', 'ी'] 

र्द्वु  :  ['र', '्', 'द', '्', 'व', 'ु'] 

र्द्वू  :  ['र', '्', 'द', '्', 'व', 'ू'] 

र्द्वे  :  ['र', '्', 'द', '्', 'व', 'े'] 

र्द्वै  :  ['र', '्', 'द', '्', 'व', 'ै'] 

र्द्वो  :  ['र', '्', 'द', '्', 'व', 'ो'] 

र्द्वौ  :  ['र', '्', 'द', '्', 'व', 'ौ'] 

र्द्वं  :  ['र', '्', 'द', '्', 'व', 'ं'] 

र्द्वः  :  ['र', '्', 'द', '्', 'व', 'ः'] 

द्वृ्  :  ['द', '्', 'व', 'ृ', '्'] 

द्वृ  :  ['द', '्', 'व', 'ृ'] 

द्वृा  :  ['द', '्', 'व', 'ृ', 'ा'] 

द्वृि  :  ['द', '्', 'व', 'ृ', 'ि'] 

द्वृी  :  ['द', '्', 'व', 'ृ', 'ी'] 

द्वृु  :  ['द', '्', 'व', 'ृ', 'ु'] 

द्वृू  :  ['द', '्', 'व', 'ृ', 'ू'] 

द्वृे  :  ['द', '्', 'व', 'ृ', 'े'] 

द्वृै  :  ['द', '्', 'व', 'ृ', 'ै'] 

द्वृो  :  ['द', '्', 'व', 'ृ', 'ो'] 

द्वृौ  :  ['द', '्', 'व', 'ृ', 'ौ'] 

द्वृं  :  ['द', '्', 'व', 'ृ', 'ं'] 

द्वृः  :  ['द', '्', 'व', 'ृ', 'ः'] 